User ID,Birthdate,City,State,Zip,Available Points,Total Points Earned,Points Spent,Joined On,Last Seen
1,1992-01-31,Minneapolis ,Georgia,55401,300,300,0,9/4/2020 0:15,12/16/2021 17:42
2,1956-05-08,Los Angeles ,Colorado,90210,320,320,0,8/19/2020 11:15,4/13/2022 14:28
3,1990-01-11,Merida,Alabama,97204,330,330,0,10/13/2020 16:20,4/21/2021 10:54
4,1990-04-16,Winston-Salem,North Carolina,27106,10790,14290,3500,8/18/2020 13:21,6/30/2022 22:22
5,1994-03-24,Winston-Salem,North Carolina,27109,650,650,0,8/21/2020 11:27,12/30/2020 10:57
6,1995-10-09,,Alabama,85588,7085,7395,310,8/18/2020 14:28,6/8/2022 23:55
7,1995-09-22,Thomasville,Alabama,29634,570,570,0,8/21/2020 10:23,4/27/2022 16:27
8,1987-02-14,Thomasville,Alaska,29634,2410,2410,0,8/22/2020 13:53,3/31/2022 1:56
9,1991-02-01,Thomasville,Arizona,29634,2895,3195,300,8/22/2020 14:03,10/10/2021 16:05
10,1999-07-20,Winston-Salem,North Carolina,27106,8465,8515,50,8/22/2020 14:42,4/9/2022 14:10
11,2000-07-22,Thomasville,Arkansas,29634,22210,22210,0,8/22/2020 15:59,6/21/2022 19:32
12,2001-05-02,Thomasville,California,29634,1355,4355,3000,8/22/2020 17:37,5/18/2021 20:57
13,1983-06-11,Thomasville,Colorado,29634,3290,3290,0,8/22/2020 18:20,4/10/2022 23:04
14,2000-11-01,Winston-Salem,North Carolina,27106,10965,17165,6200,8/22/2020 20:02,5/11/2022 15:16
15,2000-06-27,Thomasville,North Carolina,27360,5750,5750,0,8/23/2020 9:26,4/11/2022 16:27
16,1999-04-24,Thomasville,Connecticut,29634,4310,4610,300,8/23/2020 23:43,8/27/2021 13:01
17,1986-05-17,Thomasville,Delaware,29634,890,890,0,8/24/2020 11:30,1/23/2022 23:28
18,1998-07-05,Thomasville,District of Columbia,29634,550,550,0,8/24/2020 14:48,10/26/2020 10:01
19,1997-02-12,Goldsboro,North Carolina,27534,3425,3425,0,8/24/2020 15:35,6/30/2022 21:19
20,1957-06-27,Thomasville,Florida,29634,800,800,0,8/24/2020 18:23,
21,1998-11-15,Thomasville,Georgia,29634,1400,1400,0,8/25/2020 17:14,12/1/2021 14:36
22,1999-03-29,Thomasville,Hawaii,29634,2995,2995,0,8/26/2020 16:58,6/7/2021 1:01
23,2003-03-06,Thomasville,Idaho,29634,810,810,0,8/26/2020 19:30,3/29/2021 12:15
24,1950-06-17,Thomasville,Illinois,29634,300,300,0,8/30/2020 12:19,9/18/2021 23:49
25,1970-02-26,Thomasville,Indiana,29634,1300,1600,300,9/3/2020 16:27,5/30/2022 22:16
26,1999-03-15,Winston-Salem,North Carolina,27106,3635,14785,11150,9/4/2020 17:05,4/18/2022 10:57
27,1995-07-21,Thomasville,Iowa,29634,1255,1255,0,9/4/2020 17:09,5/26/2022 20:06
28,1972-01-12,Thomasville,Kansas,29634,5880,5880,0,9/4/2020 17:26,4/30/2022 8:58
29,2001-04-21,Thomasville,Kentucky,29634,4455,4455,0,9/4/2020 17:28,6/30/2022 20:36
30,1991-10-21,Thomasville,Louisiana,29634,9205,9205,0,9/4/2020 17:28,3/24/2022 18:05
31,2003-05-14,Raleigh,North Carolina,27612,12915,12925,10,9/4/2020 17:35,5/8/2022 9:30
32,1975-06-13,Thomasville,Maine,29634,14540,17340,2800,9/4/2020 17:49,4/23/2022 18:29
33,1968-06-13,Thomasville,Maryland,29634,13695,13945,250,9/4/2020 17:49,6/29/2022 18:17
34,2000-12-14,Thomasville,Massachusetts,29634,12925,15725,2800,9/4/2020 18:03,4/19/2022 16:44
35,1958-12-01,Thomasville,Michigan,29634,1175,1175,0,9/4/2020 19:01,
36,1958-07-20,Thomasville,Minnesota,29634,800,800,0,9/4/2020 19:22,
37,2000-03-02,Thomasville,Mississippi,29634,18365,18365,0,9/4/2020 20:26,6/18/2022 21:40
38,1994-06-15,Thomasville,Missouri,29634,3760,3760,0,9/4/2020 20:36,6/27/2022 17:42
39,1994-02-25,Thomasville,Montana,29634,11775,12075,300,9/4/2020 21:54,7/1/2022 8:31
40,1991-05-21,Thomasville,Nebraska,29634,8735,8735,0,9/4/2020 22:05,5/2/2022 18:00
41,1970-08-15,Thomasville,Nevada,29634,1130,1430,300,9/4/2020 22:22,4/18/2022 10:58
42,2000-06-09,Thomasville,New Hampshire,29634,2285,2285,0,9/5/2020 9:58,3/1/2021 8:00
43,1965-05-02,Thomasville,New Jersey,29634,695,695,0,9/5/2020 10:15,
44,1984-09-13,Thomasville,New Mexico,29634,11075,11075,0,9/5/2020 11:23,6/22/2022 22:44
45,1958-02-05,Thomasville,New York,29634,550,550,0,9/5/2020 12:38,1/28/2022 13:17
46,1995-07-20,Winston-Salem,North Carolina,27103,2205,2205,0,9/5/2020 12:52,12/6/2021 20:52
47,1961-03-26,Midlothian,Virginia,23113,15890,16385,495,9/5/2020 17:15,6/29/2022 20:23
48,1975-12-27,Winston-Salem ,North Carolina,27106,3310,3560,250,9/5/2020 18:39,6/5/2021 9:44
49,1966-02-10,Thomasville,North Carolina,29634,5030,5030,0,9/5/2020 20:13,2/26/2022 18:17
50,1991-09-13,Thomasville,North Dakota,29634,2590,2590,0,9/5/2020 20:38,4/7/2022 18:00
51,1962-11-28,Thomasville,Ohio,29634,2050,2050,0,9/5/2020 21:01,3/1/2022 12:27
52,2000-12-20,Thomasville,Oklahoma,29634,10190,10690,500,9/5/2020 21:46,6/30/2022 11:27
53,1999-11-18,Thomasville,Oregon,29634,2830,3330,500,9/5/2020 22:33,5/24/2022 20:14
54,2001-12-29,Bethesda ,Maryland,20814,4715,7725,3010,9/6/2020 2:14,6/30/2022 16:36
55,2002-04-20,Winston-Salem,North Carolina,27109,11245,11245,0,9/6/2020 10:25,6/6/2022 6:09
56,1998-04-19,Thomasville,Pennsylvania,29634,2165,2165,0,9/6/2020 12:48,4/19/2022 8:42
57,2001-08-15,Winston-Salem,North Carolina,27109,12190,12190,0,9/6/2020 12:53,7/1/2022 8:20
58,1966-10-24,Thomasville,Rhode Island,29634,5720,6220,500,9/6/2020 21:04,5/24/2022 14:23
59,1997-07-28,Winston-Salem,North Carolina,27109,6650,7650,1000,9/6/2020 21:05,6/30/2022 21:41
60,1999-04-27,Winston-Salem,North Carolina,27106,6340,6370,30,9/6/2020 21:05,4/19/2022 19:05
61,1995-09-20,Thomasville,South Carolina,29634,2665,2665,0,9/6/2020 21:06,6/30/2022 19:42
62,1976-10-25,Thomasville,South Dakota,29634,1160,2410,1250,9/6/2020 21:07,5/7/2021 19:07
63,2002-06-16,Thomasville,Tennessee,29634,11235,11235,0,9/6/2020 21:07,5/26/2022 21:53
64,1953-05-25,Thomasville,Texas,29634,2900,2900,0,9/6/2020 21:14,6/3/2022 23:22
65,2000-08-30,Thomasville,Utah,29634,1310,1310,0,9/6/2020 21:14,4/27/2022 9:00
66,2001-01-30,Thomasville,Vermont,29634,4875,4875,0,9/6/2020 21:15,4/18/2022 20:34
67,1998-10-12,Thomasville,Virginia,29634,120,1420,1300,9/6/2020 21:25,5/14/2021 10:19
68,1998-05-30,Thomasville,Washington,29634,1285,1285,0,9/6/2020 21:36,5/8/2021 7:27
69,1955-10-03,Thomasville,West Virginia,29634,1620,2420,800,9/6/2020 21:44,3/26/2022 16:07
70,1999-08-09,Thomasville,Wisconsin,29634,1350,1350,0,9/6/2020 21:47,
71,1998-12-09,Thomasville,Wyoming,29634,1365,1365,0,9/6/2020 21:48,11/8/2021 9:06
72,1994-01-24,Thomasville,Alabama,29634,1180,9680,8500,9/6/2020 22:00,8/23/2021 21:20
73,1999-06-26,Thomasville,Alaska,29634,1475,11175,9700,9/6/2020 22:24,12/24/2021 12:52
74,1964-11-21,Winston-Salem,North Carolina,27106,2290,12590,10300,9/6/2020 22:25,6/1/2021 19:08
75,1998-08-03,Jacksonville ,Florida,32223,1480,10530,9050,9/6/2020 22:26,1/13/2022 18:42
76,1998-12-28,Thomasville,Arizona,29634,270,7720,7450,9/6/2020 22:37,5/11/2021 9:31
77,1998-11-14,Thomasville,Arkansas,29634,2040,10240,8200,9/6/2020 22:44,2/18/2022 13:42
78,1978-07-07,Thomasville,California,29634,300,300,0,9/6/2020 22:46,
79,1999-01-07,Thomasville,Colorado,29634,1810,3560,1750,9/6/2020 22:56,5/8/2022 23:55
80,1999-05-08,Thomasville,Connecticut,29634,475,3475,3000,9/6/2020 23:08,2/16/2022 9:30
81,1981-06-03,Thomasville,Delaware,29634,400,400,0,9/6/2020 23:13,11/25/2020 13:48
82,1999-05-05,Thomasville,District of Columbia,29634,855,5605,4750,9/6/2020 23:15,8/30/2021 10:56
83,1974-06-26,Thomasville,Florida,29634,920,1420,500,9/6/2020 23:20,5/27/2022 3:19
84,2001-02-02,Thomasville,Georgia,29634,4560,4860,300,9/6/2020 23:20,4/24/2022 19:34
85,2000-05-27,Thomasville,Hawaii,29634,4765,7265,2500,9/6/2020 23:23,5/4/2022 9:03
86,2001-03-23,Thomasville,Idaho,29634,11725,12025,300,9/6/2020 23:52,5/8/2022 9:21
87,1966-04-21,Thomasville,Illinois,29634,800,800,0,9/7/2020 0:01,
88,1962-05-28,Thomasville,Indiana,29634,700,700,0,9/7/2020 0:01,
89,1998-02-27,Thomasville,Iowa,29634,700,700,0,9/7/2020 0:01,2/20/2021 14:50
90,1966-05-08,Thomasville,Kansas,29634,2195,2195,0,9/7/2020 0:09,6/8/2021 14:36
91,1999-11-23,Thomasville,Kentucky,29634,5665,14665,9000,9/7/2020 1:32,7/1/2022 6:19
92,2002-04-11,Durham,North Carolina,27707,1000,1000,0,9/7/2020 3:31,6/24/2022 18:30
93,1972-02-17,Charlotte ,North Carolina,28277,950,1350,400,9/7/2020 9:37,5/9/2021 22:47
94,1999-06-09,Thomasville,Louisiana,29634,980,1000,20,9/7/2020 10:15,9/17/2021 21:16
95,1998-01-11,Orleans ,Massachusetts,2653,960,1000,40,9/7/2020 10:18,8/23/2021 21:50
96,1965-09-05,Darien,Connecticut,6820,1370,1865,495,9/7/2020 12:03,3/25/2022 17:58
97,1988-04-09,Washington,District of Columbia,20005,2130,2150,20,9/7/2020 12:15,7/12/2021 15:36
98,1999-07-22,Thomasville,Maine,29634,2135,2135,0,9/7/2020 12:18,3/16/2022 18:42
99,1986-11-11,Thomasville,Maryland,29634,19790,20290,500,9/7/2020 12:29,6/26/2022 14:42
100,1950-09-27,Winston-Salem,North Carolina,27106,4785,7410,2625,9/7/2020 14:20,5/18/2022 11:54
101,1985-12-18,Winston-Salem,North Carolina,27106,500,700,200,9/7/2020 14:21,
102,1966-07-12,Thomasville,Massachusetts,29634,525,525,0,9/7/2020 14:22,3/15/2021 10:30
103,1956-01-08,Thomasville,Michigan,29634,1510,1510,0,9/7/2020 14:24,3/14/2022 10:00
104,1968-02-07,Thomasville,Minnesota,29634,2720,3720,1000,9/7/2020 14:25,5/11/2022 19:09
105,1959-03-11,Thomasville,Mississippi,29634,660,3660,3000,9/7/2020 14:50,9/13/2021 8:48
106,1961-06-07,Thomasville,Missouri,29634,300,300,0,9/7/2020 14:54,
107,1998-09-02,Thomasville,Montana,29634,1725,59525,57800,9/7/2020 15:16,6/29/2022 23:53
108,2001-11-16,Thomasville,Nebraska,29634,920,920,0,9/7/2020 16:04,5/18/2022 11:01
109,1979-12-03,Thomasville,Nevada,29634,1000,1000,0,9/7/2020 16:59,1/26/2022 12:16
110,1951-04-17,Thomasville,New Hampshire,29634,690,690,0,9/7/2020 17:00,11/13/2021 11:22
111,1960-05-03,Thomasville,New Jersey,29634,880,880,0,9/7/2020 17:10,5/11/2022 13:13
112,1957-09-09,Thomasville,New Mexico,29634,2835,2835,0,9/7/2020 17:17,5/20/2022 12:23
113,1952-03-16,Thomasville,New York,29634,1280,1280,0,9/7/2020 17:42,5/17/2021 10:47
114,2000-07-06,Thomasville,North Carolina,29634,2360,2860,500,9/7/2020 19:11,3/25/2022 19:51
115,1978-06-03,Thomasville,North Dakota,29634,825,825,0,9/7/2020 19:15,4/6/2022 9:18
116,2000-07-21,Thomasville,Ohio,29634,3050,3050,0,9/7/2020 19:30,3/25/2022 17:41
117,1994-07-27,Thomasville,Oklahoma,29634,990,1290,300,9/7/2020 19:30,12/11/2021 20:32
118,1983-01-11,Thomasville,Oregon,29634,2480,2480,0,9/7/2020 19:35,6/29/2022 19:21
119,1986-08-22,Thomasville,Pennsylvania,29634,3850,3850,0,9/7/2020 19:37,3/25/2022 17:38
120,2000-10-11,Thomasville,Rhode Island,29634,1740,1740,0,9/7/2020 19:40,12/4/2021 16:01
121,2001-01-21,Thomasville,South Carolina,29634,800,800,0,9/7/2020 19:51,10/30/2021 13:48
122,1992-09-09,Thomasville,South Dakota,29634,4480,4480,0,9/7/2020 20:02,5/6/2022 11:53
123,1991-12-11,Thomasville,Tennessee,29634,300,300,0,9/7/2020 21:01,
124,1998-07-31,Rocky hill,Connecticut,6067,1570,10435,8865,9/7/2020 21:24,4/20/2022 23:14
125,1999-06-21,Thomasville,Texas,29634,3610,3610,0,9/7/2020 22:24,4/16/2022 17:49
126,1967-03-09,Thomasville,Utah,29634,2155,2155,0,9/7/2020 23:16,1/12/2022 17:36
127,2001-08-27,Thomasville,Vermont,29634,1040,1040,0,9/7/2020 23:19,3/23/2022 9:42
128,1999-04-20,Thomasville,Virginia,29634,930,930,0,9/7/2020 23:27,11/23/2020 17:19
129,1956-03-21,Jackson,Mississippi,39211,4430,4330,100,9/8/2020 0:25,4/1/2022 20:32
130,1977-03-19,Thomasville,Washington,29634,550,450,0,9/8/2020 2:14,11/30/2021 18:19
131,2000-08-07,Thomasville,West Virginia,29634,6125,6925,1000,9/8/2020 7:26,4/19/2022 15:53
132,2005-01-21,Thomasville,Wisconsin,29634,1165,2165,1000,9/8/2020 10:23,12/2/2021 22:48
133,1999-07-24,Thomasville,Wyoming,29634,3080,3080,0,9/8/2020 11:12,8/21/2021 16:08
134,2004-10-07,Thomasville,Alabama,29634,1000,1000,0,9/8/2020 11:56,10/22/2020 9:15
135,1972-10-07,Thomasville,Alaska,29634,2720,2720,0,9/8/2020 12:12,4/11/2022 14:04
136,1959-01-02,Thomasville,Arizona,29634,4360,4360,0,9/8/2020 12:19,12/11/2021 19:19
137,1985-12-23,Thomasville,Arkansas,29634,600,600,0,9/8/2020 12:24,11/13/2021 17:48
138,1974-05-19,Thomasville,California,29634,2060,2060,0,9/8/2020 12:24,6/29/2022 8:02
139,1997-09-03,Thomasville,Colorado,29634,2990,2990,0,9/8/2020 12:26,10/12/2021 21:10
140,2003-12-20,Thomasville,Connecticut,29634,1310,1310,0,9/8/2020 12:27,1/2/2022 19:00
141,1975-03-25,Thomasville,Delaware,29634,2105,2105,0,9/8/2020 12:29,3/2/2022 20:54
142,1987-11-03,Thomasville,District of Columbia,29634,1150,1150,0,9/8/2020 12:31,1/23/2022 9:54
143,1953-04-10,Thomasville,Florida,29634,1210,1210,0,9/8/2020 12:32,4/8/2022 1:26
144,1977-04-08,Thomasville,Georgia,29634,2350,2350,0,9/8/2020 12:38,3/2/2022 20:45
145,2004-05-04,Thomasville,Hawaii,29634,3360,3360,0,9/8/2020 13:02,3/2/2022 20:51
146,1994-02-16,Kenneth Square,Pennsylvania,19348,1785,2845,1060,9/8/2020 13:04,1/13/2022 18:54
147,1965-10-23,Thomasville,Idaho,29634,1565,1565,0,9/8/2020 13:19,3/2/2022 8:37
148,1983-10-23,Thomasville,Illinois,29634,4080,4080,0,9/8/2020 13:22,11/14/2021 23:48
149,1956-05-23,Thomasville,Indiana,29634,1010,2260,1250,9/8/2020 13:41,4/16/2022 16:10
150,1955-12-10,Thomasville,Iowa,29634,230,530,300,9/8/2020 13:41,11/20/2021 16:18
151,1970-05-20,Thomasville,Kansas,29634,1550,1550,0,9/8/2020 13:45,2/21/2022 15:52
152,2003-06-17,Thomasville,Kentucky,29634,3580,3580,0,9/8/2020 14:08,3/17/2022 13:06
153,1979-08-02,Winston-Salem,North Carolina,27106,3650,4050,400,9/8/2020 14:30,5/28/2022 23:45
154,2000-01-03,Thomasville,Louisiana,29634,2570,2570,0,9/8/2020 14:34,5/18/2022 19:17
155,1983-05-09,Thomasville,Maine,29634,1960,1960,0,9/8/2020 14:41,3/15/2022 9:29
156,1999-06-11,Thomasville,Maryland,29634,940,2260,1320,9/8/2020 15:13,5/11/2021 20:49
157,1952-07-19,Thomasville,Massachusetts,29634,700,700,0,9/8/2020 15:18,
158,2003-10-24,Pinehurst,North Carolina,28374,1550,1600,50,9/8/2020 15:22,4/18/2022 18:26
159,1958-10-14,Thomasville,Michigan,29634,2760,3260,500,9/8/2020 15:32,4/8/2022 19:46
160,1999-05-27,Thomasville,Minnesota,29634,2380,2380,0,9/8/2020 15:38,3/2/2022 20:36
161,1990-12-16,Thomasville,Mississippi,29634,1400,1400,0,9/8/2020 15:46,11/27/2021 21:22
162,1992-03-20,Thomasville,Missouri,29634,1235,1235,0,9/8/2020 15:50,10/22/2020 20:05
163,1954-06-16,Thomasville,Montana,29634,1250,1250,0,9/8/2020 16:21,
164,1998-12-14,Thomasville,Nebraska,29634,2960,2960,0,9/8/2020 17:01,5/3/2022 17:52
165,1991-06-17,Oak Ridge,North Carolina,27310,4800,5400,600,9/8/2020 17:02,3/15/2022 9:04
166,1967-03-07,Thomasville,Nevada,29634,2305,2305,0,9/8/2020 17:04,4/18/2022 10:57
167,1969-08-10,Thomasville,New Hampshire,29634,1785,1785,0,9/8/2020 17:06,3/2/2022 21:29
168,1957-01-19,Thomasville,New Jersey,29634,1200,1200,0,9/8/2020 17:06,10/14/2020 16:20
169,1993-05-22,Thomasville,New Mexico,29634,1060,1360,300,9/8/2020 17:09,11/13/2021 19:33
170,1969-07-15,Thomasville,New York,29634,1775,1775,0,9/8/2020 17:10,2/23/2022 10:27
171,1966-06-10,Thomasville,North Carolina,29634,2350,2350,0,9/8/2020 17:12,4/15/2022 20:26
172,1984-09-27,Thomasville,North Dakota,29634,3010,3010,0,9/8/2020 17:12,4/15/2022 19:20
173,1987-01-26,Cary,North Carolina,27513,2185,2235,50,9/8/2020 17:15,3/2/2022 12:59
174,1972-06-15,Thomasville,Ohio,29634,1680,1680,0,9/8/2020 17:15,11/13/2020 19:15
175,1999-09-15,Thomasville,Oklahoma,29634,1485,1485,0,9/8/2020 17:16,7/3/2021 14:29
176,1968-11-03,Thomasville,Oregon,29634,4200,4200,0,9/8/2020 17:17,6/30/2022 18:09
177,1978-04-12,Thomasville,Pennsylvania,29634,2865,2865,0,9/8/2020 17:19,4/19/2022 14:05
178,1990-03-26,Thomasville,Rhode Island,29634,960,960,0,9/8/2020 17:20,1/19/2022 9:36
179,2002-05-22,Thomasville,South Carolina,29634,1110,1670,560,9/8/2020 17:23,3/1/2022 11:29
180,1987-07-11,Charlotte,North Carolina,28277,2330,2480,150,9/8/2020 17:25,4/10/2022 16:19
181,2000-09-16,Thomasville,South Dakota,29634,5405,5905,500,9/8/2020 17:30,4/22/2022 14:52
182,2005-04-09,Thomasville,Tennessee,29634,960,960,0,9/8/2020 17:33,11/30/2021 20:50
183,1956-09-17,Thomasville,Texas,29634,3030,3530,500,9/8/2020 17:33,4/16/2022 16:28
184,1951-11-17,Thomasville,Utah,29634,720,720,0,9/8/2020 17:35,4/11/2022 14:02
185,1983-03-06,Thomasville,Vermont,29634,8605,8605,0,9/8/2020 17:37,1/10/2022 20:55
186,1998-12-28,Thomasville,Virginia,29634,1150,3650,2500,9/8/2020 17:40,6/11/2022 9:29
187,1954-03-04,Thomasville,Washington,29634,960,1460,500,9/8/2020 17:56,2/18/2022 23:11
188,1993-05-25,Thomasville,West Virginia,29634,10245,10245,0,9/8/2020 17:58,4/19/2022 17:00
189,1967-05-27,Thomasville,Wisconsin,29634,7620,7620,0,9/8/2020 18:10,6/26/2022 20:46
190,1999-05-19,Thomasville,Wyoming,29634,1465,1465,0,9/8/2020 18:15,5/24/2021 7:49
191,1975-07-27,Thomasville,Alabama,29634,810,810,0,9/8/2020 18:19,1/20/2022 13:48
192,1967-09-16,Thomasville,Alaska,29634,2530,2530,0,9/8/2020 18:27,5/27/2022 2:16
193,1992-01-28,Thomasville,Arizona,29634,1280,1280,0,9/8/2020 18:29,5/13/2021 22:17
194,2000-02-16,Winston-Salem,North Carolina,27106,1235,12520,11285,9/8/2020 18:35,6/28/2022 15:53
195,1957-08-14,Thomasville,Arkansas,29634,2310,2610,300,9/8/2020 18:51,3/19/2022 10:42
196,1956-04-11,Shaker Hts,Ohio,44120,3280,3330,50,9/8/2020 19:00,4/10/2022 11:42
197,1973-02-14,Thomasville,California,29634,2820,2820,0,9/8/2020 19:05,3/22/2022 15:16
198,2002-03-12,Thomasville,Colorado,29634,5520,5520,0,9/8/2020 19:07,6/30/2022 12:23
199,2000-07-04,Thomasville,Connecticut,29634,350,850,500,9/8/2020 19:09,1/11/2022 17:19
200,2005-04-10,Thomasville,Delaware,29634,2760,2760,0,9/8/2020 19:15,4/1/2022 19:16
201,1975-11-08,Thomasville,District of Columbia,29634,510,510,0,9/8/2020 19:15,2/26/2022 18:45
202,2001-10-24,Thomasville,Florida,29634,2160,2660,500,9/8/2020 19:16,4/1/2022 18:05
203,1952-10-09,Thomasville,Georgia,29634,400,400,0,9/8/2020 19:17,
204,1964-08-15,Wilmette,Illinois,60091,350,4350,4000,9/8/2020 19:23,4/19/2022 17:51
205,1966-08-09,Thomasville,Hawaii,29634,1550,1550,0,9/8/2020 19:25,3/2/2022 20:53
206,1957-08-01,Thomasville,Idaho,29634,680,980,300,9/8/2020 19:49,3/2/2022 19:20
207,2001-09-05,Thomasville,Illinois,29634,6145,6145,0,9/8/2020 20:09,6/30/2022 10:03
208,1981-12-27,Thomasville,Indiana,29634,850,850,0,9/8/2020 20:10,10/20/2020 20:00
209,1960-12-05,Thomasville,Iowa,29634,1820,1820,0,9/8/2020 20:11,2/24/2022 20:17
210,1959-10-24,Thomasville,Kansas,29634,1400,1400,0,9/8/2020 20:21,2/26/2022 18:42
211,2002-04-11,Thomasville,Kentucky,29634,2535,4535,2000,9/8/2020 20:27,6/30/2022 17:45
212,1978-04-15,Loveland,Ohio,45140,2025,8950,6925,9/8/2020 20:41,6/27/2022 7:34
213,2000-09-13,Thomasville,Louisiana,29634,2350,2350,0,9/8/2020 20:44,1/9/2022 13:28
214,1989-04-16,Thomasville,Maine,29634,865,865,0,9/8/2020 20:49,1/15/2022 5:14
215,1962-05-16,Thomasville,Maryland,29634,650,1150,500,9/8/2020 20:49,2/27/2022 16:29
216,1970-02-15,Thomasville,Massachusetts,29634,1695,1695,0,9/8/2020 20:53,10/17/2020 15:25
217,2004-09-13,Thomasville,Michigan,29634,775,775,0,9/8/2020 20:54,2/12/2022 14:06
218,1953-05-03,Thomasville,Minnesota,29634,5900,5900,0,9/8/2020 20:56,6/30/2022 19:26
219,1970-04-06,Thomasville,Mississippi,29634,1600,2100,500,9/8/2020 20:59,2/11/2022 14:48
220,1980-11-14,Thomasville,Missouri,29634,1170,1170,0,9/8/2020 21:04,5/8/2022 9:21
221,2001-07-25,Thomasville,Montana,29634,2230,2230,0,9/8/2020 21:04,5/7/2022 20:26
222,2004-06-26,Thomasville,Nebraska,29634,600,600,0,9/8/2020 21:06,1/10/2022 18:13
223,2002-01-22,Thomasville,Nevada,29634,5035,5535,500,9/8/2020 21:10,6/5/2022 21:39
224,1970-01-21,Thomasville,New Hampshire,29634,1290,1290,0,9/8/2020 21:12,4/15/2022 11:10
225,1964-09-26,Thomasville,New Jersey,29634,1150,1150,0,9/8/2020 21:12,1/22/2022 18:26
226,1989-09-01,Thomasville,New Mexico,29634,550,550,0,9/8/2020 21:12,1/12/2022 7:59
227,1953-08-16,Thomasville,New York,29634,4490,4490,0,9/8/2020 21:16,4/19/2022 20:45
228,2003-01-05,Thomasville,North Carolina,29634,600,600,0,9/8/2020 21:18,1/10/2022 10:51
229,1962-07-12,Thomasville,North Dakota,29634,810,810,0,9/8/2020 21:22,6/5/2022 11:14
230,1968-09-05,Thomasville,Ohio,29634,1520,1520,0,9/8/2020 21:23,4/15/2022 12:26
231,1980-12-13,Thomasville,Oklahoma,29634,450,750,300,9/8/2020 21:23,2/18/2022 17:58
232,2001-08-04,Thomasville,Oregon,29634,800,800,0,9/8/2020 21:25,1/23/2022 23:18
233,1998-10-18,Thomasville,Pennsylvania,29634,100,400,300,9/8/2020 21:26,10/15/2020 10:05
234,1997-02-12,Thomasville,Rhode Island,29634,610,1110,500,9/8/2020 21:31,1/12/2022 19:17
235,2001-10-05,Thomasville,South Carolina,29634,450,850,400,9/8/2020 21:33,3/15/2022 20:36
236,2001-10-20,Thomasville,South Dakota,29634,11100,11300,200,9/8/2020 21:35,6/30/2022 13:51
237,2005-06-12,Thomasville,Tennessee,29634,600,600,0,9/8/2020 21:42,11/14/2021 0:31
238,2021-10-27,Thomasville,Texas,29634,1435,1935,500,9/8/2020 21:46,2/26/2022 18:41
239,2001-05-06,Thomasville,Utah,29634,5380,5380,0,9/8/2020 21:48,5/2/2022 11:07
240,1971-07-10,Thomasville,Vermont,29634,450,750,300,9/8/2020 21:54,3/7/2022 18:05
241,1972-11-16,Thomasville,Virginia,29634,5470,5470,0,9/8/2020 21:59,5/21/2022 19:09
242,1957-08-28,Thomasville,Washington,29634,6905,6905,0,9/8/2020 21:59,2/5/2022 18:58
243,1967-01-18,Thomasville,West Virginia,29634,7680,7680,0,9/8/2020 22:01,4/16/2022 16:11
244,2001-01-19,Thomasville,Wisconsin,29634,11430,11730,300,9/8/2020 22:22,4/14/2022 10:00
245,2000-04-04,Winston-Salem,North Carolina,27106,7880,8430,550,9/8/2020 22:29,5/18/2022 11:03
246,1989-03-24,Thomasville,Wyoming,29634,5965,5965,0,9/8/2020 22:34,4/18/2022 10:57
247,2001-09-29,Thomasville,Alabama,29634,1350,1350,0,9/8/2020 22:34,3/5/2022 14:30
248,2000-03-02,Thomasville,Alaska,29634,2415,2415,0,9/8/2020 22:37,4/19/2022 12:43
249,1971-08-15,Thomasville,Arizona,29634,1360,1360,0,9/8/2020 22:38,5/9/2022 18:06
250,1964-11-23,Thomasville,Arkansas,29634,850,850,0,9/8/2020 22:38,3/1/2022 17:25
251,1980-04-21,Thomasville,California,29634,1175,1475,300,9/8/2020 22:38,3/16/2022 14:00
252,1962-06-14,Thomasville,Colorado,29634,475,475,0,9/8/2020 22:39,
253,1999-12-28,Thomasville,Connecticut,29634,7730,17730,10000,9/8/2020 22:57,5/31/2022 10:42
254,2001-09-06,Thomasville,Delaware,29634,2930,3680,750,9/8/2020 22:59,5/4/2022 9:10
255,2001-07-25,Thomasville,District of Columbia,29634,825,825,0,9/8/2020 23:01,4/23/2021 20:56
256,2001-09-23,Thomasville,Florida,29634,6810,6810,0,9/8/2020 23:02,5/12/2022 3:06
257,1999-03-09,Thomasville,Georgia,29634,490,490,0,9/8/2020 23:02,2/9/2022 9:01
258,1953-03-09,Thomasville,Hawaii,29634,8880,17880,9000,9/8/2020 23:08,4/29/2022 16:05
259,2001-05-24,Thomasville,Idaho,29634,400,400,0,9/8/2020 23:11,
260,2002-04-17,Thomasville,Illinois,29634,5955,5955,0,9/8/2020 23:25,4/18/2022 19:03
261,1955-10-18,Thomasville,Indiana,29634,1610,1610,0,9/8/2020 23:26,4/8/2022 10:25
262,2000-04-21,Winston-Salem,North Carolina,27109,485,15385,14900,9/8/2020 23:30,6/1/2022 21:42
263,1960-06-05,Thomasville,Iowa,29634,2140,2440,300,9/8/2020 23:37,5/10/2022 18:12
264,1996-09-10,Thomasville,Kansas,29634,5895,5895,0,9/8/2020 23:40,6/20/2022 21:08
265,1951-02-16,Thomasville,Kentucky,29634,400,400,0,9/8/2020 23:41,
266,1984-05-28,Thomasville,Louisiana,29634,920,1220,300,9/8/2020 23:43,1/17/2022 12:46
267,1964-02-19,Thomasville,Maine,29634,1165,1165,0,9/8/2020 23:45,1/12/2022 17:58
268,1977-08-22,Thomasville,Maryland,29634,2090,2090,0,9/8/2020 23:48,5/7/2022 14:11
269,1958-07-16,Thomasville,Massachusetts,29634,1150,1150,0,9/8/2020 23:48,2/23/2022 10:45
270,1964-06-18,Thomasville,Michigan,29634,2035,2035,0,9/8/2020 23:51,4/13/2022 9:04
271,2001-09-18,Thomasville,Minnesota,29634,1570,1770,200,9/8/2020 23:53,1/22/2022 20:05
272,2001-10-09,Thomasville,Mississippi,29634,13290,22140,8850,9/9/2020 0:00,4/14/2022 8:27
273,1993-08-11,Thomasville,Missouri,29634,860,1860,1000,9/9/2020 0:45,1/22/2022 21:53
274,1992-02-14,Thomasville,Montana,29634,7375,9875,2500,9/9/2020 7:39,5/21/2022 17:54
275,1953-04-20,Thomasville,Nebraska,29634,6610,6610,0,9/9/2020 8:08,6/30/2022 10:30
276,1998-10-10,Thomasville,Nevada,29634,1040,1040,0,9/9/2020 8:38,4/9/2022 16:07
277,1952-08-22,Winston-Salem ,North Carolina,27107,925,7120,6195,9/9/2020 8:39,5/25/2022 21:20
278,1966-06-05,Thomasville,New Hampshire,29634,975,975,0,9/9/2020 8:42,3/17/2022 10:00
279,1972-01-23,Thomasville,New Jersey,29634,2030,2030,0,9/9/2020 9:10,5/3/2022 18:17
280,2000-12-08,Thomasville,New Mexico,29634,7370,7370,0,9/9/2020 9:17,5/9/2022 13:14
281,1955-05-06,Thomasville,New York,29634,3050,3050,0,9/9/2020 9:20,3/28/2022 16:27
282,1963-08-21,Thomasville,North Carolina,29634,3010,3010,0,9/9/2020 9:33,4/15/2022 14:02
283,1991-10-09,Thomasville,North Dakota,29634,1580,1580,0,9/9/2020 9:34,5/2/2022 15:49
284,1960-05-06,Thomasville,Ohio,29634,2860,2860,0,9/9/2020 9:37,6/20/2022 19:08
285,1962-12-15,Thomasville,Oklahoma,29634,820,1320,500,9/9/2020 9:40,3/24/2022 16:04
286,1998-04-10,Thomasville,Oregon,29634,700,700,0,9/9/2020 9:45,
287,1997-06-26,Thomasville,Pennsylvania,29634,1665,1965,300,9/9/2020 9:50,3/23/2022 16:57
288,1982-09-05,Thomasville,Rhode Island,29634,1350,1650,300,9/9/2020 9:51,3/25/2022 18:02
289,1954-10-14,Thomasville,South Carolina,29634,360,860,500,9/9/2020 9:57,4/19/2022 17:22
290,1999-09-20,Thomasville,South Dakota,29634,400,400,0,9/9/2020 10:03,
291,2005-08-18,Thomasville,Tennessee,29634,2985,2985,0,9/9/2020 10:10,3/22/2022 15:14
292,2001-02-06,Thomasville,Texas,29634,5970,11970,6000,9/9/2020 10:13,6/30/2022 13:27
293,1984-01-09,Thomasville,Utah,29634,1050,1050,0,9/9/2020 10:15,3/16/2022 19:50
294,1997-09-01,Thomasville,Vermont,29634,1525,1525,0,9/9/2020 10:15,4/11/2022 14:00
295,1959-04-18,Thomasville,Virginia,29634,2790,2790,0,9/9/2020 10:16,5/10/2021 10:53
296,2001-04-13,Winston-Salem ,North Carolina,27106,2525,2550,25,9/9/2020 10:43,5/2/2021 19:52
297,1998-04-16,Thomasville,Washington,29634,1800,1800,0,9/9/2020 10:43,4/5/2022 1:02
298,1967-05-03,Thomasville,West Virginia,29634,2360,2360,0,9/9/2020 10:44,3/1/2022 12:00
299,1973-01-18,Thomasville,Wisconsin,29634,2110,2110,0,9/9/2020 10:48,4/15/2022 23:31
300,2001-04-03,Thomasville,Wyoming,29634,1350,1350,0,9/9/2020 10:50,3/2/2022 21:20
301,1998-09-25,Thomasville,Alabama,29634,460,4960,4500,9/9/2020 10:53,6/16/2021 13:22
302,1983-09-23,Thomasville,Alaska,29634,1680,1680,0,9/9/2020 10:53,4/19/2022 13:58
303,1966-03-23,Winston-Salem,North Carolina,27106,3325,4725,1400,9/9/2020 10:55,5/24/2022 10:11
304,1994-03-13,Thomasville,Arizona,29634,1230,1230,0,9/9/2020 10:59,5/16/2021 20:02
305,1984-04-08,Winston-Salem ,North Carolina,27107,3235,4660,1425,9/9/2020 11:05,5/11/2022 17:49
306,1964-08-20,Thomasville,Arkansas,29634,1500,1500,0,9/9/2020 11:19,2/21/2022 14:19
307,1990-06-16,Glen Mills,Pennsylvania,19342,2775,2795,20,9/9/2020 11:29,6/12/2022 16:12
308,1965-03-21,Thomasville,California,29634,4140,4140,0,9/9/2020 11:31,3/23/2022 16:13
309,1975-01-14,Thomasville,Colorado,29634,2745,2745,0,9/9/2020 11:35,6/24/2022 14:06
310,1983-03-11,Thomasville,Connecticut,29634,2000,2000,0,9/9/2020 11:39,3/16/2022 18:29
311,1982-06-17,Thomasville,Delaware,29634,1720,2020,300,9/9/2020 11:49,4/27/2022 15:42
312,1969-09-25,Thomasville,District of Columbia,29634,3230,3230,0,9/9/2020 11:53,4/9/2022 14:15
313,1989-07-18,Thomasville,Florida,29634,2535,2535,0,9/9/2020 12:18,4/10/2022 12:23
314,1958-04-01,Thomasville,Georgia,29634,960,960,0,9/9/2020 12:22,4/6/2022 9:28
315,1959-05-04,Thomasville,Hawaii,29634,2730,2730,0,9/9/2020 12:33,6/15/2022 23:41
316,1958-05-23,Thomasville,Idaho,29634,2295,2595,300,9/9/2020 12:39,2/13/2022 16:10
317,1952-07-07,Thomasville,Illinois,29634,7365,7365,0,9/9/2020 12:46,5/7/2022 21:51
318,1984-05-03,Thomasville,Indiana,29634,3480,3480,0,9/9/2020 12:47,6/30/2022 11:09
319,1983-11-19,Thomasville,Iowa,29634,500,500,0,9/9/2020 12:49,
320,1983-04-03,Dallas,Texas,75220,410,710,300,9/9/2020 12:50,4/15/2022 8:46
321,2001-09-12,Thomasville,Kansas,29634,7485,7485,0,9/9/2020 12:51,6/22/2022 16:32
322,2002-01-25,Thomasville,Kentucky,29634,4805,4805,0,9/9/2020 12:53,4/10/2022 17:04
323,1951-07-18,Thomasville,Louisiana,29634,1060,1060,0,9/9/2020 12:55,12/2/2021 12:56
324,2002-06-18,Thomasville,Maine,29634,460,460,0,9/9/2020 13:05,12/9/2021 19:38
325,1958-09-06,Thomasville,Maryland,29634,850,850,0,9/9/2020 13:10,12/30/2020 12:38
326,2000-01-13,Thomasville,Massachusetts,29634,2960,2960,0,9/9/2020 13:14,5/29/2022 16:07
327,1973-03-23,Thomasville,Michigan,29634,1160,1160,0,9/9/2020 13:19,4/25/2022 22:12
328,1999-07-12,Thomasville,Minnesota,29634,1000,1000,0,9/9/2020 13:20,12/16/2020 18:01
329,2002-06-03,Thomasville,Mississippi,29634,5895,5895,0,9/9/2020 13:20,5/14/2022 23:08
330,1969-09-10,Thomasville,Missouri,29634,200,700,500,9/9/2020 13:20,1/12/2022 18:31
331,1954-01-27,Thomasville,Montana,29634,4885,5085,200,9/9/2020 13:23,5/26/2022 20:08
332,1986-11-09,Thomasville,Nebraska,29634,4385,4385,0,9/9/2020 13:30,5/19/2022 22:15
333,2002-01-13,Thomasville,Nevada,29634,2560,3060,500,9/9/2020 13:30,6/6/2022 8:37
334,2000-11-24,Thomasville,New Hampshire,29634,6880,6880,0,9/9/2020 13:31,5/10/2022 20:04
335,1976-06-25,Thomasville,New Jersey,29634,3255,3255,0,9/9/2020 13:31,1/31/2022 12:08
336,1960-06-09,Thomasville,New Mexico,29634,950,950,0,9/9/2020 13:39,1/10/2022 16:07
337,2000-05-12,Thomasville,New York,29634,5650,5650,0,9/9/2020 13:42,5/28/2022 14:04
338,2005-01-07,Thomasville,North Carolina,29634,4215,4215,0,9/9/2020 13:45,5/6/2022 14:15
339,1955-04-15,Atlanta,Georgia,30305,3100,3910,810,9/9/2020 13:45,3/27/2022 13:01
340,1990-03-16,Winston-Salem,North Carolina,27109,1155,1615,460,9/9/2020 13:47,3/2/2022 20:34
341,1951-12-12,Thomasville,North Dakota,29634,5675,5675,0,9/9/2020 13:47,2/26/2022 19:56
342,1953-04-23,San Francisco,California,94105,3670,3680,10,9/9/2020 13:49,4/17/2022 14:05
343,1997-10-28,Winston-Salem,North Carolina,27109,1050,1850,800,9/9/2020 13:51,5/23/2022 13:30
344,1964-02-03,Thomasville,Ohio,29634,4890,4890,0,9/9/2020 13:51,6/8/2022 21:35
345,1998-11-02,Thomasville,Oklahoma,29634,1270,2270,1000,9/9/2020 13:52,5/6/2022 11:48
346,1994-12-27,Thomasville,Oregon,29634,940,2190,1250,9/9/2020 13:52,5/10/2022 20:25
347,1954-10-20,Thomasville,Pennsylvania,29634,1100,1100,0,9/9/2020 13:52,4/6/2022 23:23
348,1996-04-01,Thomasville,Rhode Island,29634,3125,3125,0,9/9/2020 13:54,4/9/2022 10:17
349,1992-01-06,Thomasville,South Carolina,29634,400,400,0,9/9/2020 13:54,3/10/2022 23:00
350,1984-04-07,Thomasville,South Dakota,29634,2100,2100,0,9/9/2020 13:56,3/15/2022 10:49
351,1990-11-17,Atlanta ,Georgia,30327,960,2160,1200,9/9/2020 13:57,5/4/2022 9:52
352,1974-09-15,Thomasville,Tennessee,29634,1270,1270,0,9/9/2020 13:59,4/12/2022 20:21
353,1959-12-02,Thomasville,Texas,29634,1035,1335,300,9/9/2020 14:00,7/10/2021 12:51
354,1958-10-01,Madison,Connecticut,6443,4400,5400,1000,9/9/2020 14:08,6/25/2022 15:29
355,1967-02-26,Winston-Salem,North Carolina,27106,7475,8600,1125,9/9/2020 14:11,7/1/2022 8:15
356,1959-06-03,Thomasville,Utah,29634,770,770,0,9/9/2020 14:12,1/22/2022 16:36
357,2002-08-23,Thomasville,Vermont,29634,2800,2800,0,9/9/2020 14:13,3/31/2022 19:37
358,2000-08-15,Thomasville,Virginia,29634,3045,3045,0,9/9/2020 14:15,6/30/2022 23:55
359,2000-12-12,Thomasville,Washington,29634,1660,1660,0,9/9/2020 14:18,3/5/2021 21:46
360,1993-08-18,Thomasville,West Virginia,29634,1185,1185,0,9/9/2020 14:19,1/17/2022 12:47
361,1996-10-06,Winston-Salem,North Carolina,27109,7635,8135,500,9/9/2020 14:35,5/12/2022 16:42
362,1996-06-16,Thomasville,Wisconsin,29634,5810,7810,2000,9/9/2020 14:35,4/19/2022 19:39
363,1997-04-02,Thomasville,Wyoming,29634,400,400,0,9/9/2020 14:45,3/17/2022 12:46
364,1999-02-09,Thomasville,Alabama,29634,3905,7405,3500,9/9/2020 14:46,6/2/2021 10:17
365,1997-03-12,Thomasville,Alaska,29634,1250,1250,0,9/9/2020 14:47,11/21/2021 17:57
366,2000-06-29,Delran,New Jersey,8075,15015,18115,3100,9/9/2020 14:48,5/10/2022 18:01
367,1999-12-15,Thomasville,Arizona,29634,15125,18775,3650,9/9/2020 14:50,5/10/2022 18:22
368,2001-12-24,Thomasville,Arkansas,29634,1645,1945,300,9/9/2020 14:51,4/15/2022 21:00
369,2002-10-06,Thomasville,California,29634,5330,5330,0,9/9/2020 14:53,6/30/2022 14:18
370,1972-11-09,Thomasville,Colorado,29634,1100,1100,0,9/9/2020 14:53,1/12/2022 19:12
371,1962-08-14,Thomasville,Connecticut,29634,5715,6715,1000,9/9/2020 14:57,4/15/2022 19:45
372,1995-10-01,Thomasville,Delaware,29634,1880,1880,0,9/9/2020 14:58,2/12/2022 9:18
373,1975-11-08,Thomasville,District of Columbia,29634,4110,4410,300,9/9/2020 15:00,4/26/2022 14:38
374,1999-11-02,Milwaukee,Wisconsin,53217,2890,11940,9050,9/9/2020 15:16,5/11/2022 18:32
375,1968-02-23,Thomasville,Florida,29634,1670,1670,0,9/9/2020 15:17,4/18/2022 10:57
376,1960-09-24,Thomasville,Georgia,29634,2860,2860,0,9/9/2020 15:23,4/10/2022 12:52
377,1985-02-13,Thomasville,Hawaii,29634,4800,5100,300,9/9/2020 15:24,6/30/2022 22:18
378,1983-12-19,Thomasville,Idaho,29634,1450,1450,0,9/9/2020 15:24,2/20/2022 15:43
379,1990-07-03,Thomasville,Illinois,29634,2390,2390,0,9/9/2020 15:26,2/19/2022 12:25
380,1976-11-22,Thomasville,Indiana,29634,1185,1185,0,9/9/2020 15:34,6/10/2022 18:44
381,1982-06-16,Thomasville,Iowa,29634,8575,8575,0,9/9/2020 15:35,6/16/2022 8:16
382,1952-12-02,Thomasville,Kansas,29634,290,1290,1000,9/9/2020 15:45,1/21/2022 1:46
383,1998-05-27,Thomasville,Kentucky,29634,2005,2005,0,9/9/2020 15:45,5/20/2021 6:58
384,1983-01-17,Thomasville,Louisiana,29634,3620,3620,0,9/9/2020 15:46,3/19/2022 13:04
385,1961-01-12,Winston-Salem,North Carolina,27106,295,6315,6020,9/9/2020 15:46,3/25/2022 18:12
386,1952-10-18,Thomasville,Maine,29634,2480,2970,490,9/9/2020 16:01,4/19/2022 17:24
387,1980-02-26,Thomasville,Maryland,29634,800,1100,300,9/9/2020 16:02,4/30/2021 22:30
388,2001-05-20,Lincoln University,Pennsylvania,19352,11235,11235,0,9/9/2020 16:12,4/15/2022 18:21
389,1973-06-15,Thomasville,Massachusetts,29634,4075,4675,600,9/9/2020 16:14,4/26/2022 13:31
390,1992-03-20,Thomasville,Michigan,29634,460,460,0,9/9/2020 16:18,4/29/2022 16:01
391,1963-04-13,Thomasville,Minnesota,29634,2260,2560,300,9/9/2020 16:19,12/2/2021 23:57
392,1956-08-28,Thomasville,Mississippi,29634,2490,3490,1000,9/9/2020 16:21,4/22/2022 18:29
393,2002-05-12,Thomasville,Missouri,29634,800,1100,300,9/9/2020 16:25,3/19/2022 15:22
394,1953-11-04,Thomasville,Montana,29634,1075,1075,0,9/9/2020 16:29,1/10/2022 14:51
395,1961-05-20,Thomasville,Nebraska,29634,615,615,0,9/9/2020 16:34,
396,1997-04-24,Thomasville,Nevada,29634,1015,1015,0,9/9/2020 16:46,10/20/2020 0:27
397,1999-07-13,Thomasville,New Hampshire,29634,3185,3185,0,9/9/2020 16:49,4/2/2022 16:58
398,1973-02-27,Thomasville,New Jersey,29634,510,510,0,9/9/2020 16:57,3/13/2022 11:30
399,1972-01-24,Thomasville,New Mexico,29634,810,810,0,9/9/2020 16:59,6/22/2022 15:22
400,1997-04-17,Thomasville,New York,29634,1930,1930,0,9/9/2020 17:01,5/9/2021 13:19
401,1986-03-18,Thomasville,North Carolina,29634,1850,2150,300,9/9/2020 17:01,3/16/2022 14:14
402,1974-05-16,Thomasville,North Dakota,29634,1150,1150,0,9/9/2020 17:01,3/3/2021 10:30
403,1994-11-17,Winston-Salem ,North Carolina,27106,770,830,60,9/9/2020 17:02,4/29/2021 13:23
404,1994-07-22,Winston-Salem,North Carolina,27106,250,760,510,9/9/2020 17:02,2/26/2021 12:41
405,2000-06-24,Winston-Salem,North Carolina,27106,2590,2620,30,9/9/2020 17:02,3/14/2022 9:04
406,1968-08-06,Thomasville,Ohio,29634,1950,1950,0,9/9/2020 17:02,1/12/2022 18:46
407,2000-10-07,Thomasville,Oklahoma,29634,1915,2415,500,9/9/2020 17:03,5/14/2022 18:26
408,1983-09-15,Thomasville,Oregon,29634,5370,5370,0,9/9/2020 17:03,6/30/2022 3:57
409,2002-06-11,Thomasville,Pennsylvania,29634,1780,1780,0,9/9/2020 17:04,2/12/2022 21:08
410,1984-08-15,Thomasville,Rhode Island,29634,8680,8680,0,9/9/2020 17:04,5/12/2022 17:20
411,1956-01-05,Thomasville,South Carolina,29634,2290,3290,1000,9/9/2020 17:05,5/8/2022 15:15
412,1954-07-16,Thomasville,South Dakota,29634,3260,3260,0,9/9/2020 17:05,6/28/2022 8:26
413,1984-07-23,Thomasville,Tennessee,29634,80,880,800,9/9/2020 17:06,5/15/2021 11:21
414,1954-08-03,Thomasville,Texas,29634,2010,2010,0,9/9/2020 17:06,4/16/2022 12:48
415,1987-12-05,Thomasville,Utah,29634,400,400,0,9/9/2020 17:07,
416,2001-07-25,Thomasville,Vermont,29634,500,500,0,9/9/2020 17:08,9/4/2021 18:34
417,1983-01-09,Thomasville,Virginia,29634,2355,2355,0,9/9/2020 17:09,4/12/2022 23:23
418,1972-09-14,Thomasville,Washington,29634,780,780,0,9/9/2020 17:09,3/16/2022 16:00
419,1999-07-19,Thomasville,West Virginia,29634,2845,2845,0,9/9/2020 17:10,2/12/2022 17:40
420,1979-02-03,Thomasville,Wisconsin,29634,3055,3055,0,9/9/2020 17:12,11/27/2021 20:00
421,1996-03-09,Thomasville,Wyoming,29634,760,760,0,9/9/2020 17:13,4/16/2022 16:40
422,1994-11-04,Thomasville,Alabama,29634,3310,3310,0,9/9/2020 17:14,4/17/2022 16:31
423,2005-02-19,Thomasville,Alaska,29634,2640,2640,0,9/9/2020 17:14,6/29/2022 12:19
424,1958-07-22,Thomasville,Arizona,29634,3310,3310,0,9/9/2020 17:14,4/2/2022 14:14
425,1992-06-01,Thomasville,Arkansas,29634,1785,1785,0,9/9/2020 17:14,2/11/2022 10:49
426,1992-07-05,Thomasville,California,29634,750,1750,1000,9/9/2020 17:15,5/11/2022 19:24
427,1994-07-13,Thomasville,Colorado,29634,3880,3880,0,9/9/2020 17:16,5/11/2022 18:48
428,1964-06-01,Thomasville,Connecticut,29634,1500,1500,0,9/9/2020 17:17,
429,1981-02-28,Thomasville,Delaware,29634,700,700,0,9/9/2020 17:17,
430,1982-04-20,Thomasville,District of Columbia,29634,1390,1390,0,9/9/2020 17:17,4/27/2022 20:13
431,1995-09-02,Thomasville,Florida,29634,1465,1465,0,9/9/2020 17:17,4/9/2022 22:44
432,1972-04-03,Thomasville,Georgia,29634,870,870,0,9/9/2020 17:23,5/9/2021 20:25
433,1975-03-14,Thomasville,Hawaii,29634,400,400,0,9/9/2020 17:23,
434,1951-04-20,Thomasville,Idaho,29634,700,700,0,9/9/2020 17:24,3/2/2021 13:42
435,1972-10-17,Thomasville,Illinois,29634,800,800,0,9/9/2020 17:24,6/26/2021 19:01
436,1995-09-27,Asheboro,North Carolina,27205,20,2445,2425,9/9/2020 17:24,5/8/2022 0:42
437,2004-12-08,Thomasville,Indiana,29634,950,950,0,9/9/2020 17:27,1/12/2022 18:23
438,2001-06-06,Thomasville,Iowa,11011,2825,3125,300,9/9/2020 17:28,4/10/2022 12:52
439,1968-01-26,Thomasville,Kansas,29634,2510,3110,600,9/9/2020 17:28,2/8/2022 13:47
440,1992-11-05,Thomasville,Kentucky,29634,1650,1650,0,9/9/2020 17:28,4/27/2022 14:46
441,2001-01-16,Thomasville,Louisiana,29634,2690,3190,500,9/9/2020 17:29,3/16/2022 17:23
442,2001-08-03,Thomasville,Maine,29634,7535,7535,0,9/9/2020 17:29,5/26/2022 20:10
443,1957-04-17,Thomasville,Maryland,29634,540,540,0,9/9/2020 17:29,9/11/2021 14:02
444,1961-07-21,Thomasville,Massachusetts,29634,950,950,0,9/9/2020 17:30,5/20/2021 15:16
445,2000-10-02,Thomasville,Michigan,29634,3420,3420,0,9/9/2020 17:32,4/2/2022 3:35
446,1980-09-26,Thomasville,Minnesota,29634,1580,1580,0,9/9/2020 17:34,3/19/2022 14:59
447,1962-03-11,Thomasville,Mississippi,29634,100,400,300,9/9/2020 17:34,
448,2001-10-17,Thomasville,Missouri,29634,5560,6160,600,9/9/2020 17:38,4/9/2022 13:31
449,1994-09-17,Thomasville,Montana,29634,1980,1980,0,9/9/2020 17:40,2/10/2022 10:28
450,2002-03-05,Thomasville,Nebraska,29634,4985,4985,0,9/9/2020 17:41,6/30/2022 23:10
451,1995-02-12,Thomasville,Nevada,29634,470,470,0,9/9/2020 17:43,1/12/2022 18:06
452,1978-12-17,Thomasville,New Hampshire,29634,765,765,0,9/9/2020 17:43,11/30/2021 17:19
453,1954-01-24,Thomasville,New Jersey,29634,1050,1050,0,9/9/2020 17:45,2/1/2022 20:00
454,1997-02-25,Thomasville,New Mexico,29634,515,515,0,9/9/2020 17:45,2/19/2022 19:22
455,1993-09-16,Winston-Salem,North Carolina,27103,15,935,920,9/9/2020 17:46,2/1/2021 8:41
456,1961-02-12,Winston-Salem,North Carolina,27109,1910,3010,1100,9/9/2020 17:46,3/5/2022 16:05
457,1988-08-01,Thomasville,New York,29634,400,400,0,9/9/2020 17:47,
458,2002-05-11,Thomasville,North Carolina,29634,1725,1725,0,9/9/2020 17:48,4/7/2022 13:19
459,1975-09-28,Thomasville,North Dakota,29634,695,695,0,9/9/2020 17:49,3/2/2022 20:51
460,1959-10-09,Thomasville,Ohio,29634,990,1290,300,9/9/2020 17:50,2/8/2022 20:13
461,1995-02-25,Mooresville,North Carolina,28115,6570,8445,1875,9/9/2020 17:50,4/19/2022 16:41
462,1950-04-25,Thomasville,Oklahoma,29634,3195,3195,0,9/9/2020 17:51,5/4/2022 15:58
463,1954-11-10,Thomasville,Oregon,29634,3765,3765,0,9/9/2020 17:51,4/20/2022 10:52
464,1981-08-06,Thomasville,Pennsylvania,29634,3290,3290,0,9/9/2020 17:52,4/10/2022 15:05
465,1986-09-16,Thomasville,Rhode Island,29634,500,500,0,9/9/2020 17:58,
466,1976-09-18,Thomasville,South Carolina,29634,1410,1410,0,9/9/2020 18:01,3/26/2022 10:45
467,1989-02-03,Thomasville,South Dakota,29634,600,600,0,9/9/2020 18:03,3/16/2022 18:47
468,1987-10-09,Hickory,North Carolina,28601,2820,3920,1100,9/9/2020 18:04,5/4/2022 16:53
469,1962-07-04,Thomasville,Tennessee,29634,1000,1000,0,9/9/2020 18:05,11/19/2021 11:32
470,1984-06-04,Charlotte,North Carolina,28211,475,575,100,9/9/2020 18:06,10/19/2020 11:43
471,2001-05-26,Thomasville,Texas,29634,2895,2895,0,9/9/2020 18:08,3/2/2022 10:13
472,1985-09-20,Thomasville,Utah,29634,905,905,0,9/9/2020 18:10,
473,1961-12-13,Thomasville,Vermont,29634,2105,3855,1750,9/9/2020 18:10,3/19/2022 17:41
474,1956-11-11,Thomasville,Virginia,29634,1970,1970,0,9/9/2020 18:14,4/16/2022 15:21
475,1958-08-25,Thomasville,Washington,29634,1165,1165,0,9/9/2020 18:15,5/8/2021 13:18
476,1978-05-06,Thomasville,West Virginia,29634,4340,4340,0,9/9/2020 18:16,4/2/2022 12:11
477,1966-03-03,Thomasville,Wisconsin,29634,2365,2365,0,9/9/2020 18:17,4/18/2022 16:19
478,1973-03-28,Thomasville,Wyoming,29634,735,1235,500,9/9/2020 18:24,3/5/2022 4:58
479,1980-11-24,Thomasville,Alabama,29634,660,1110,450,9/9/2020 18:27,4/16/2022 12:11
480,1989-05-06,Thomasville,Alaska,29634,400,400,0,9/9/2020 18:29,
481,1984-07-04,Thomasville,Arizona,29634,10235,10535,300,9/9/2020 18:38,5/9/2022 17:14
482,1996-05-23,Thomasville,Arkansas,29634,415,1215,800,9/9/2020 18:48,2/2/2021 18:08
483,1999-09-04,Thomasville,California,29634,1080,1080,0,9/9/2020 18:49,3/28/2022 16:02
484,1987-03-23,Thomasville,Colorado,29634,6095,6095,0,9/9/2020 18:58,6/26/2022 13:03
485,2004-04-16,Thomasville,Connecticut,29634,2645,2645,0,9/9/2020 19:00,1/22/2022 18:41
486,1974-02-17,Thomasville,Delaware,29634,7440,7440,0,9/9/2020 19:09,6/29/2022 23:04
487,1995-07-17,Thomasville,District of Columbia,29634,2400,2400,0,9/9/2020 19:12,3/14/2022 11:23
488,1974-05-03,Thomasville,Florida,29634,1315,1315,0,9/9/2020 19:14,1/30/2022 19:39
489,2003-11-18,Thomasville,Georgia,29634,705,705,0,9/9/2020 19:16,4/9/2022 14:18
490,1959-04-27,Thomasville,Hawaii,29634,1305,1305,0,9/9/2020 19:27,5/9/2022 18:20
491,1977-08-25,Thomasville,Idaho,29634,450,450,0,9/9/2020 19:31,2/2/2021 16:12
492,1975-07-07,Thomasville,Illinois,29634,675,675,0,9/9/2020 19:34,11/27/2021 15:21
493,2002-02-17,Thomasville,Indiana,29634,12085,12085,0,9/9/2020 19:35,5/3/2022 12:24
494,1996-12-11,Thomasville,Iowa,29634,3160,3160,0,9/9/2020 19:36,4/16/2022 19:45
495,1950-11-11,Thomasville,Kansas,29634,725,725,0,9/9/2020 19:36,11/13/2021 18:24
496,1993-09-07,Thomasville,Kentucky,29634,750,1050,300,9/9/2020 19:38,2/25/2021 18:57
497,1966-11-03,Thomasville,Louisiana,29634,400,400,0,9/9/2020 19:38,2/12/2022 14:08
498,1989-11-11,Thomasville,Maine,29634,750,750,0,9/9/2020 19:39,11/27/2021 22:23
499,2002-01-04,Thomasville,Maryland,29634,2370,2370,0,9/9/2020 19:40,4/8/2022 19:17
500,2002-10-03,Thomasville,Massachusetts,29634,3050,3050,0,9/9/2020 19:40,3/19/2022 15:33
501,1953-12-28,Thomasville,Michigan,29634,860,1360,500,9/9/2020 19:40,4/20/2022 0:12
502,1999-11-29,Thomasville,Minnesota,29634,4115,12615,8500,9/9/2020 19:41,5/26/2022 20:44
503,2000-05-08,Thomasville,Mississippi,29634,2495,9995,7500,9/9/2020 19:42,6/29/2022 8:54
504,2002-06-09,Thomasville,Missouri,29634,19010,19010,0,9/9/2020 19:42,6/30/2022 19:28
505,1951-07-06,Thomasville,Montana,29634,550,1050,500,9/9/2020 19:44,3/29/2022 20:18
506,1976-02-25,Thomasville,Nebraska,29634,3610,7110,3500,9/9/2020 19:48,5/13/2022 10:04
507,1968-07-19,Thomasville,Nevada,29634,650,650,0,9/9/2020 19:48,1/19/2022 19:05
508,1984-11-15,Thomasville,New Hampshire,29634,1350,1350,0,9/9/2020 19:52,2/26/2022 19:21
509,1980-10-14,Thomasville,New Jersey,29634,710,710,0,9/9/2020 19:52,1/22/2022 16:24
510,1974-08-17,Thomasville,New Mexico,29634,1600,1600,0,9/9/2020 20:03,3/17/2022 18:25
511,2000-03-21,Perry,New York,14530,10315,10340,25,9/9/2020 20:09,6/24/2022 14:17
512,1974-01-12,Thomasville,New York,29634,900,1200,300,9/9/2020 20:11,3/6/2021 19:13
513,1965-07-24,Thomasville,North Carolina,29634,795,1295,500,9/9/2020 20:12,6/30/2022 0:15
514,1996-06-03,Thomasville,North Dakota,29634,2205,2505,300,9/9/2020 20:14,3/25/2022 18:41
515,1992-07-09,Thomasville,Ohio,29634,220,670,450,9/9/2020 20:16,3/23/2022 11:06
516,1989-04-12,Thomasville,Oklahoma,29634,735,1035,300,9/9/2020 20:16,4/27/2021 22:16
517,1976-10-26,Thomasville,Oregon,29634,1425,1425,0,9/9/2020 20:16,5/3/2021 11:47
518,2003-03-26,Thomasville,Pennsylvania,29634,450,900,450,9/9/2020 20:17,2/18/2022 13:10
519,1951-05-09,Thomasville,Rhode Island,29634,750,750,0,9/9/2020 20:17,
520,1958-09-14,Thomasville,South Carolina,29634,1120,1120,0,9/9/2020 20:19,4/13/2022 11:35
521,2002-05-05,Thomasville,South Dakota,29634,460,460,0,9/9/2020 20:21,3/13/2022 10:33
522,2001-12-05,Thomasville,Tennessee,29634,2180,11180,9000,9/9/2020 20:21,7/1/2022 7:48
523,1959-08-10,Thomasville,Texas,29634,1000,1000,0,9/9/2020 20:23,
524,1969-04-15,Thomasville,Utah,29634,740,1040,300,9/9/2020 20:24,5/11/2021 17:25
525,1983-02-13,Thomasville,Vermont,29634,700,700,0,9/9/2020 20:26,10/21/2020 18:33
526,2000-07-24,Thomasville,Virginia,29634,805,1105,300,9/9/2020 20:26,4/27/2021 18:30
527,1961-06-23,Thomasville,Washington,29634,2400,2400,0,9/9/2020 20:28,2/19/2022 13:04
528,1983-06-02,Thomasville,West Virginia,29634,2100,2100,0,9/9/2020 20:30,3/2/2022 20:30
529,1973-03-03,Thomasville,Wisconsin,29634,700,700,0,9/9/2020 20:32,
530,1954-10-09,Thomasville,Wyoming,29634,1885,1885,0,9/9/2020 20:32,4/27/2022 17:28
531,1961-11-10,Thomasville,Alabama,29634,1365,2165,800,9/9/2020 20:34,5/6/2021 11:45
532,1957-09-02,Thomasville,Alaska,29634,1300,2300,1000,9/9/2020 20:37,3/6/2022 9:04
533,2001-10-04,Thomasville,Arizona,29634,1110,1110,0,9/9/2020 20:37,2/12/2022 20:02
534,1984-12-15,Thomasville,Arkansas,29634,400,400,0,9/9/2020 20:39,1/1/2022 18:25
535,1994-12-23,Thomasville,California,29634,2350,2350,0,9/9/2020 20:42,3/15/2022 9:05
536,1964-05-02,Thomasville,Colorado,29634,550,550,0,9/9/2020 20:46,10/2/2021 10:29
537,1968-10-03,Thomasville,Connecticut,29634,1000,1000,0,9/9/2020 20:55,
538,2002-02-03,Thomasville,Delaware,29634,1720,1720,0,9/9/2020 20:57,4/30/2022 9:07
539,1992-11-24,Thomasville,District of Columbia,29634,400,400,0,9/9/2020 21:00,9/18/2021 14:09
540,1954-08-23,Thomasville,Florida,29634,3090,3090,0,9/9/2020 21:02,11/29/2021 22:39
541,1996-12-09,Thomasville,Georgia,29634,975,975,0,9/9/2020 21:05,3/8/2022 14:19
542,2004-11-23,Thomasville,Hawaii,29634,4030,4030,0,9/9/2020 21:07,4/3/2022 16:00
543,1971-07-15,Thomasville,Idaho,29634,6400,6400,0,9/9/2020 21:08,5/26/2022 20:36
544,1971-12-23,Thomasville,Illinois,29634,5745,5745,0,9/9/2020 21:10,5/17/2022 17:36
545,1996-08-09,Thomasville,Indiana,29634,1620,1620,0,9/9/2020 21:14,4/8/2022 18:18
546,1986-10-24,Thomasville,Iowa,29634,3260,3260,0,9/9/2020 21:15,5/7/2022 11:49
547,1955-05-09,Thomasville,Kansas,29634,525,6525,6000,9/9/2020 21:15,4/27/2022 15:33
548,1992-03-10,Thomasville,Kentucky,29634,4150,4150,0,9/9/2020 21:16,2/24/2022 18:07
549,1954-10-26,Thomasville,Louisiana,29634,2580,4330,1750,9/9/2020 21:16,3/8/2022 22:01
550,1982-08-02,Thomasville,Maine,29634,700,700,0,9/9/2020 21:17,
551,1976-07-25,Thomasville,Maryland,29634,985,985,0,9/9/2020 21:28,5/4/2021 15:42
552,1991-02-15,Thomasville,Massachusetts,29634,110,410,300,9/9/2020 21:34,5/27/2022 8:56
553,2001-11-18,Thomasville,Michigan,29634,4310,4310,0,9/9/2020 21:35,5/28/2022 13:34
554,2002-06-20,Thomasville,Minnesota,29634,1010,1510,500,9/9/2020 21:40,3/2/2022 21:17
555,1998-02-10,Thomasville,Mississippi,29634,450,450,0,9/9/2020 21:46,11/14/2021 1:13
556,1965-05-20,Thomasville,Missouri,29634,920,920,0,9/9/2020 21:47,11/13/2021 10:06
557,1982-11-25,Thomasville,Montana,29634,7705,7705,0,9/9/2020 21:47,5/24/2022 10:41
558,1962-02-15,Thomasville,Nebraska,29634,3895,3895,0,9/9/2020 21:53,1/12/2022 19:52
559,1996-12-15,Thomasville,Nevada,29634,790,790,0,9/9/2020 21:54,5/4/2022 10:34
560,1951-06-05,Thomasville,New Hampshire,29634,1325,1625,300,9/9/2020 21:55,11/25/2021 16:00
561,1957-09-21,Thomasville,New Jersey,29634,920,920,0,9/9/2020 21:55,3/30/2022 11:10
562,1986-08-01,Thomasville,New Mexico,29634,1045,1045,0,9/9/2020 21:55,6/21/2021 13:08
563,2001-11-07,Thomasville,New York,29634,6850,6850,0,9/9/2020 22:06,4/2/2022 16:14
564,1953-04-10,Thomasville,North Carolina,29634,1060,1060,0,9/9/2020 22:10,1/22/2022 14:31
565,2001-04-19,Thomasville,North Dakota,29634,600,600,0,9/9/2020 22:11,3/2/2022 11:03
566,1955-09-23,Thomasville,Ohio,29634,1990,2290,300,9/9/2020 22:15,4/10/2022 14:19
567,1964-06-25,Thomasville,Oklahoma,29634,2780,2780,0,9/9/2020 22:18,4/30/2022 18:32
568,1972-11-04,Thomasville,Oregon,29634,100,400,300,9/9/2020 22:29,10/18/2020 13:32
569,1975-03-10,Thomasville,Pennsylvania,29634,2010,2010,0,9/9/2020 22:30,5/1/2022 19:34
570,1964-05-28,Thomasville,Rhode Island,29634,900,900,0,9/9/2020 22:35,8/29/2021 21:59
571,1957-03-18,Thomasville,South Carolina,29634,2940,2940,0,9/9/2020 22:40,3/14/2022 9:01
572,2001-07-17,Atlanta,Georgia,30338,1295,2105,810,9/9/2020 22:42,2/12/2022 14:45
573,1997-05-01,Winston-Salem,North Carolina,29701,1320,1330,10,9/9/2020 22:46,3/5/2021 19:19
574,2001-07-26,Thomasville,South Dakota,29634,650,950,300,9/9/2020 23:09,3/25/2022 18:13
575,1967-03-05,Thomasville,Tennessee,29634,1050,1050,0,9/9/2020 23:10,3/15/2022 9:22
576,1950-03-07,Thomasville,Texas,29634,700,700,0,9/9/2020 23:22,
577,1981-04-15,Thomasville,Utah,29634,700,700,0,9/9/2020 23:29,8/27/2021 14:01
578,1970-08-03,Thomasville,Vermont,29634,660,960,300,9/9/2020 23:42,4/11/2021 11:53
579,1954-01-24,Thomasville,Virginia,29634,1400,1400,0,9/9/2020 23:48,3/2/2022 20:34
580,1956-08-22,Thomasville,Washington,29634,4260,4260,0,9/9/2020 23:53,3/2/2022 23:08
581,1971-06-01,Medina,Minnesota,55340,1945,2000,55,9/9/2020 23:58,2/25/2022 18:25
582,1953-08-09,Winston-Salem ,North Carolina,27104,1125,1950,825,9/9/2020 23:58,3/8/2022 15:47
583,1991-09-27,Thomasville,West Virginia,29634,935,935,0,9/10/2020 0:18,6/2/2021 17:27
584,1981-12-28,Thomasville,Wisconsin,29634,500,500,0,9/10/2020 0:31,
585,1961-03-28,Thomasville,Wyoming,29634,3790,3790,0,9/10/2020 0:32,5/26/2022 20:14
586,2002-09-07,Thomasville,Alabama,29634,2265,2865,600,9/10/2020 0:32,5/16/2022 10:58
587,2000-03-12,Winston-Salem,North Carolina,27109,5855,11805,5950,9/10/2020 1:02,5/3/2022 17:54
588,1962-03-25,Thomasville,Alaska,29634,2930,3930,1000,9/10/2020 1:13,2/20/2022 16:25
589,1977-01-24,Thomasville,Arizona,29634,1335,1335,0,9/10/2020 1:33,11/30/2021 22:24
590,1997-07-15,Thomasville,Arkansas,29634,600,600,0,9/10/2020 6:43,
591,1998-09-15,Charlotte,North Carolina,28277,1100,1100,0,9/10/2020 8:34,11/27/2021 19:04
592,1960-09-15,Thomasville,California,29634,2480,2480,0,9/10/2020 9:15,4/16/2022 16:40
593,2002-02-18,Thomasville,Colorado,29634,2405,4155,1750,9/10/2020 9:38,3/15/2022 16:36
594,1950-11-18,Thomasville,Connecticut,29634,615,615,0,9/10/2020 9:40,
595,2000-06-19,Thomasville,Delaware,29634,4240,4240,0,9/10/2020 10:37,5/13/2022 0:41
596,1967-02-26,Thomasville,District of Columbia,29634,1450,1450,0,9/10/2020 10:50,12/5/2021 21:16
597,1979-12-02,Thomasville,Florida,29634,700,700,0,9/10/2020 10:56,2/26/2022 19:13
598,1992-01-26,Thomasville,Georgia,29634,5655,6155,500,9/10/2020 11:00,6/30/2022 19:56
599,2002-01-13,Thomasville,Hawaii,29634,835,835,0,9/10/2020 11:11,1/21/2022 13:27
600,1979-05-06,Thomasville,Idaho,29634,2260,2260,0,9/10/2020 11:21,4/9/2022 12:17
601,1961-05-14,Thomasville,Illinois,29634,5130,5130,0,9/10/2020 11:26,6/22/2022 23:22
602,1956-11-22,Aurora ,Colorado,80016,14530,15030,500,9/10/2020 11:30,6/30/2022 21:48
603,1984-09-19,Thomasville,Indiana,29634,900,1400,500,9/10/2020 11:39,3/18/2022 9:20
604,2003-10-23,Thomasville,Iowa,29634,1320,1320,0,9/10/2020 11:44,6/25/2022 23:16
605,1999-08-17,Thomasville,Kansas,29634,5090,5090,0,9/10/2020 12:14,6/30/2022 5:01
606,1961-10-03,Thomasville,Kentucky,29634,4520,4520,0,9/10/2020 12:16,4/10/2022 14:18
607,1985-02-17,Thomasville,Louisiana,29634,1070,1070,0,9/10/2020 12:17,12/2/2021 19:49
608,1960-11-06,Thomasville,Maine,29634,1400,1400,0,9/10/2020 12:18,
609,1966-01-18,Thomasville,Maryland,29634,110,11410,11300,9/10/2020 12:18,4/26/2022 9:41
610,1965-08-17,Thomasville,Massachusetts,29634,1000,1000,0,9/10/2020 12:19,
611,1987-01-09,Thomasville,Michigan,29634,1375,1375,0,9/10/2020 12:20,4/18/2022 18:03
612,1963-11-16,Thomasville,Minnesota,29634,1360,1360,0,9/10/2020 12:20,4/18/2022 18:07
613,1955-01-13,Thomasville,Mississippi,29634,700,700,0,9/10/2020 12:22,
614,1972-04-26,Thomasville,Missouri,29634,3010,3010,0,9/10/2020 12:23,5/4/2022 9:30
615,1976-02-05,Thomasville,Montana,29634,7650,7650,0,9/10/2020 12:23,4/19/2022 19:09
616,1982-11-13,Thomasville,Nebraska,29634,1720,2720,1000,9/10/2020 12:24,4/18/2022 13:51
617,1993-05-26,Charlotte,North Carolina,28209,1030,2380,1350,9/10/2020 12:25,6/22/2021 18:14
618,1955-03-26,Thomasville,Nevada,29634,700,700,0,9/10/2020 12:25,
619,1966-03-07,Winston-Salem,North Carolina,27103,8425,8555,130,9/10/2020 12:25,5/12/2022 16:36
620,1995-07-13,Thomasville,New Hampshire,29634,345,945,600,9/10/2020 12:26,3/20/2021 13:46
621,2001-03-02,Thomasville,New Jersey,29634,10825,10825,0,9/10/2020 12:27,4/19/2022 18:11
622,2001-05-12,Thomasville,New Mexico,29634,1280,1280,0,9/10/2020 12:27,8/27/2021 19:00
623,1958-12-02,Thomasville,New York,29634,2170,2170,0,9/10/2020 12:27,4/11/2022 10:14
624,2001-01-23,Thomasville,North Carolina,29634,17285,17285,0,9/10/2020 12:27,6/30/2022 15:08
625,2000-02-02,Austin,Texas,78620,3580,4115,535,9/10/2020 12:28,7/1/2022 8:15
626,1999-12-15,Thomasville,North Dakota,29634,13880,13880,0,9/10/2020 12:28,6/17/2022 1:22
627,1972-02-02,Thomasville,Ohio,29634,3520,3520,0,9/10/2020 12:28,3/10/2022 15:52
628,1986-01-20,Thomasville,Oklahoma,29634,1400,1400,0,9/10/2020 12:29,10/12/2020 14:57
629,1997-09-27,Thomasville,Oregon,29634,3460,3460,0,9/10/2020 12:29,4/8/2022 12:50
630,1963-05-15,Thomasville,Pennsylvania,29634,1550,1550,0,9/10/2020 12:29,
631,1991-07-19,Thomasville,Rhode Island,29634,1450,2450,1000,9/10/2020 12:30,2/26/2022 19:03
632,1993-10-08,Thomasville,South Carolina,29634,1950,1950,0,9/10/2020 12:32,12/3/2021 22:00
633,2000-10-29,Thomasville,South Dakota,29634,11350,15150,3800,9/10/2020 12:32,6/30/2022 14:39
634,1969-11-04,Dublin,Ohio,43016,3865,12615,8750,9/10/2020 12:33,3/26/2022 16:55
635,1986-07-06,Thomasville,Tennessee,29634,915,1415,500,9/10/2020 12:33,4/20/2022 9:35
636,1985-03-19,Thomasville,Texas,29634,5180,5180,0,9/10/2020 12:33,5/7/2022 20:39
637,1984-07-02,Thomasville,Utah,29634,5660,5660,0,9/10/2020 12:34,5/7/2022 21:16
638,1952-01-15,Thomasville,Vermont,29634,1150,1150,0,9/10/2020 12:34,1/22/2022 18:33
639,2001-03-06,Thomasville,Virginia,29634,5095,5095,0,9/10/2020 12:35,4/8/2022 12:43
640,1964-06-16,Thomasville,Washington,29634,1165,1665,500,9/10/2020 12:36,2/9/2022 21:10
641,2000-10-26,Thomasville,West Virginia,29634,1080,1080,0,9/10/2020 12:36,5/3/2022 18:33
642,1978-04-13,Thomasville,Wisconsin,29634,1750,1750,0,9/10/2020 12:37,2/26/2022 19:05
643,1959-09-17,Thomasville,Wyoming,29634,860,860,0,9/10/2020 12:37,4/10/2022 11:01
644,1959-02-08,Thomasville,Alabama,29634,21115,28515,7400,9/10/2020 12:37,5/18/2022 13:11
645,1997-12-14,Thomasville,Alaska,29634,510,1110,600,9/10/2020 12:37,4/16/2022 19:05
646,2001-08-09,Thomasville,Arizona,29634,6135,6135,0,9/10/2020 12:38,6/25/2022 9:32
647,1989-06-09,Thomasville,Arkansas,29634,1150,2150,1000,9/10/2020 12:38,6/27/2022 21:35
648,2002-08-14,Thomasville,California,29634,2035,2535,500,9/10/2020 12:38,11/27/2021 16:01
649,1975-05-09,Thomasville,Colorado,29634,1315,1315,0,9/10/2020 12:39,11/30/2021 11:51
650,1991-01-11,Thomasville,Connecticut,29634,1250,1250,0,9/10/2020 12:39,3/9/2022 19:36
651,2000-07-09,Thomasville,Delaware,29634,1400,1400,0,9/10/2020 12:39,1/22/2022 18:54
652,1991-08-17,Thomasville,District of Columbia,29634,8110,8410,300,9/10/2020 12:40,5/26/2022 20:06
653,1959-04-08,Thomasville,Florida,29634,2390,2390,0,9/10/2020 12:40,6/24/2022 13:37
654,2002-02-13,Thomasville,Georgia,29634,3730,3730,0,9/10/2020 12:40,6/28/2022 22:37
655,2000-01-21,Thomasville,Hawaii,29634,955,1255,300,9/10/2020 12:41,4/16/2022 13:26
656,1974-03-07,Thomasville,Idaho,29634,560,860,300,9/10/2020 12:41,3/17/2022 10:18
657,1998-10-04,Chapel Hill,North Carolina,27516,1535,1535,0,9/10/2020 12:42,1/31/2022 10:29
658,1998-08-07,Thomasville,Illinois,29634,970,970,0,9/10/2020 12:42,2/12/2022 14:17
659,1982-08-03,Thomasville,Indiana,29634,730,730,0,9/10/2020 12:42,5/9/2021 15:12
660,1999-08-11,Thomasville,Iowa,29634,760,760,0,9/10/2020 12:42,4/15/2022 14:52
661,1958-01-03,Thomasville,Kansas,29634,2915,4415,1500,9/10/2020 12:42,3/16/2022 18:52
662,2002-04-19,Thomasville,Kentucky,29634,1790,1790,0,9/10/2020 12:43,4/8/2022 19:24
663,2001-09-24,Thomasville,Louisiana,29634,1800,1800,0,9/10/2020 12:43,1/18/2022 14:56
664,1973-09-28,Thomasville,Maine,29634,850,850,0,9/10/2020 12:43,10/21/2020 10:47
665,2004-04-28,Thomasville,Maryland,29634,4735,4735,0,9/10/2020 12:43,6/23/2022 23:10
666,1961-11-18,Thomasville,Massachusetts,29634,500,500,0,9/10/2020 12:43,
667,1991-02-09,Thomasville,Michigan,29634,2810,2810,0,9/10/2020 12:43,4/8/2022 17:16
668,1974-10-15,Thomasville,Minnesota,29634,2160,2160,0,9/10/2020 12:44,4/18/2022 11:00
669,1996-02-23,Thomasville,Mississippi,29634,950,950,0,9/10/2020 12:44,3/24/2022 11:44
670,1980-08-15,Thomasville,Missouri,29634,800,800,0,9/10/2020 12:44,2/22/2022 19:15
671,1965-01-16,Thomasville,Montana,29634,1200,1700,500,9/10/2020 12:44,3/5/2022 17:26
672,1957-05-19,Thomasville,Nebraska,29634,1100,1100,0,9/10/2020 12:44,3/8/2022 14:05
673,1999-12-08,Thomasville,Nevada,29634,900,900,0,9/10/2020 12:45,1/22/2022 20:00
674,1997-08-26,Thomasville,New Hampshire,29634,820,820,0,9/10/2020 12:45,5/11/2021 9:59
675,2000-08-14,Thomasville,New Jersey,29634,4560,4560,0,9/10/2020 12:45,5/21/2022 13:36
676,1992-01-10,Thomasville,New Mexico,29634,1200,1200,0,9/10/2020 12:45,
677,1989-09-03,Thomasville,New York,29634,4190,4190,0,9/10/2020 12:46,4/11/2022 8:39
678,1989-01-27,Thomasville,North Carolina,29634,3230,3230,0,9/10/2020 12:46,4/19/2022 15:26
679,2000-02-15,Thomasville,North Dakota,29634,1410,1410,0,9/10/2020 12:46,4/14/2022 10:28
680,1959-12-01,Thomasville,Ohio,29634,2210,2210,0,9/10/2020 12:46,4/23/2022 10:25
681,2002-04-15,Thomasville,Oklahoma,29634,1450,1450,0,9/10/2020 12:46,2/15/2022 7:32
682,2003-01-08,Thomasville,Oregon,29634,570,1070,500,9/10/2020 12:47,3/30/2022 11:08
683,1970-10-01,Thomasville,Pennsylvania,29634,5010,5010,0,9/10/2020 12:47,5/3/2022 20:43
684,1952-10-28,Thomasville,Rhode Island,29634,16555,17155,600,9/10/2020 12:47,5/3/2022 8:24
685,2000-01-18,Thomasville,South Carolina,29634,1150,1150,0,9/10/2020 12:47,1/22/2022 14:42
686,1992-10-01,Thomasville,South Dakota,29634,2370,2370,0,9/10/2020 12:47,5/3/2022 17:35
687,1952-07-03,Thomasville,Tennessee,29634,2270,2270,0,9/10/2020 12:47,6/29/2022 18:51
688,1952-05-10,Thomasville,Texas,29634,1300,1300,0,9/10/2020 12:47,2/22/2022 14:27
689,2000-05-13,Thomasville,Utah,29634,4630,4630,0,9/10/2020 12:48,6/27/2022 20:46
690,1968-08-17,Thomasville,Vermont,29634,3370,3370,0,9/10/2020 12:48,5/3/2022 10:59
691,1986-10-05,Thomasville,Virginia,29634,3795,3795,0,9/10/2020 12:49,5/2/2022 18:10
692,2000-01-11,Thomasville,Washington,29634,1760,2260,500,9/10/2020 12:49,4/15/2022 15:37
693,1966-12-26,Thomasville,West Virginia,29634,4725,4725,0,9/10/2020 12:50,3/13/2022 22:15
694,1964-04-07,Thomasville,Wisconsin,29634,1260,1260,0,9/10/2020 12:50,6/10/2022 23:46
695,1977-10-20,Thomasville,Wyoming,29634,2770,2770,0,9/10/2020 12:50,6/6/2022 22:37
696,1999-12-15,Thomasville,Alabama,29634,14470,14470,0,9/10/2020 12:50,6/26/2022 11:30
697,2000-08-02,Winston-Salem,North Carolina,27106,1310,1310,0,9/10/2020 12:50,5/30/2022 13:33
698,1967-09-01,Thomasville,Alaska,29634,1620,1620,0,9/10/2020 12:51,5/11/2022 13:01
699,1969-02-17,Thomasville,Arizona,29634,1625,1625,0,9/10/2020 12:52,5/9/2022 17:13
700,1958-12-06,Thomasville,Arkansas,29634,1300,1300,0,9/10/2020 12:52,1/11/2022 19:40
701,1992-12-04,Thomasville,California,29634,6970,6970,0,9/10/2020 12:52,5/12/2022 10:14
702,1997-04-10,Thomasville,Colorado,29634,1100,1100,0,9/10/2020 12:52,2/15/2022 22:52
703,1962-02-16,Winston-Salem,North Carolina,27109,3800,8550,4750,9/10/2020 12:52,5/11/2022 19:41
704,1973-12-17,Thomasville,Connecticut,29634,4415,4415,0,9/10/2020 12:53,6/10/2022 17:44
705,1994-11-20,Thomasville,Delaware,29634,2210,2210,0,9/10/2020 12:53,1/22/2022 21:40
706,2000-11-27,Thomasville,District of Columbia,29634,1450,1450,0,9/10/2020 12:54,11/30/2020 18:12
707,1988-01-27,Thomasville,Florida,29634,1550,1550,0,9/10/2020 12:54,2/28/2022 21:48
708,2000-12-20,Winston-Salem,North Carolina,27106,10940,10960,20,9/10/2020 12:55,6/4/2022 21:24
709,1965-06-03,Thomasville,Georgia,29634,1550,1550,0,9/10/2020 12:55,11/30/2021 21:31
710,1962-02-28,Thomasville,Hawaii,29634,3150,3150,0,9/10/2020 12:55,3/19/2022 16:05
711,2000-02-26,Thomasville,Idaho,29634,2330,2330,0,9/10/2020 12:55,7/1/2022 0:48
712,1968-03-01,Thomasville,Illinois,29634,400,400,0,9/10/2020 12:55,
713,2000-01-10,Thomasville,Indiana,29634,7850,7850,0,9/10/2020 12:55,5/23/2022 20:15
714,1996-11-08,Thomasville,Iowa,29634,1795,1795,0,9/10/2020 12:55,3/2/2022 10:43
715,1983-06-14,Thomasville,Kansas,29634,1500,2000,500,9/10/2020 12:55,3/15/2022 18:34
716,1966-08-23,Thomasville,Kentucky,29634,2155,2155,0,9/10/2020 12:55,3/24/2022 19:14
717,1999-04-12,Thomasville,Louisiana,29634,9395,9695,300,9/10/2020 12:56,3/19/2022 18:57
718,1954-09-06,Thomasville,Maine,29634,3400,3700,300,9/10/2020 12:58,5/8/2022 14:45
719,1999-04-22,Thomasville,Maryland,29634,1310,1310,0,9/10/2020 12:58,4/30/2022 8:58
720,1980-08-06,Thomasville,Massachusetts,29634,3010,3010,0,9/10/2020 12:58,4/25/2022 23:28
721,1976-09-16,Thomasville,Michigan,29634,2660,2660,0,9/10/2020 12:58,3/25/2022 18:10
722,1952-04-25,Thomasville,Minnesota,29634,1630,1630,0,9/10/2020 13:00,2/26/2022 22:48
723,1967-03-10,Thomasville,Mississippi,29634,1050,1050,0,9/10/2020 13:00,4/13/2022 9:17
724,1958-04-07,Glenview ,Illinois,60025,4050,4375,325,9/10/2020 13:00,2/28/2022 17:56
725,1983-01-11,Thomasville,Missouri,29634,1400,1400,0,9/10/2020 13:01,1/12/2022 18:27
726,1950-06-26,Thomasville,Montana,29634,850,850,0,9/10/2020 13:01,1/12/2022 18:06
727,1994-02-25,Thomasville,Nebraska,29634,1370,1370,0,9/10/2020 13:01,5/8/2022 11:26
728,2001-08-14,Thomasville,Nevada,29634,4260,4260,0,9/10/2020 13:02,5/19/2022 2:52
729,1964-07-14,Thomasville,New Hampshire,29634,2760,2760,0,9/10/2020 13:03,5/21/2022 21:42
730,2001-07-24,Thomasville,New Jersey,29634,3800,3800,0,9/10/2020 13:03,6/30/2022 9:39
731,1963-09-19,Thomasville,New Mexico,29634,800,800,0,9/10/2020 13:03,5/24/2021 19:59
732,1976-01-07,Thomasville,New York,29634,1100,1100,0,9/10/2020 13:03,3/1/2022 11:29
733,1952-03-02,Thomasville,North Carolina,29634,1230,1230,0,9/10/2020 13:03,3/20/2022 11:43
734,1971-11-22,Thomasville,North Dakota,29634,580,580,0,9/10/2020 13:03,5/26/2022 22:25
735,1975-11-07,Thomasville,Ohio,29634,2170,2170,0,9/10/2020 13:03,4/15/2022 14:02
736,1966-08-14,Thomasville,Oklahoma,29634,2160,2160,0,9/10/2020 13:03,2/26/2022 12:31
737,2002-02-01,Thomasville,Oregon,29634,3770,3770,0,9/10/2020 13:03,4/4/2022 23:22
738,1961-11-01,Thomasville,Pennsylvania,29634,2530,2530,0,9/10/2020 13:04,5/5/2022 21:23
739,2000-10-14,Thomasville,Rhode Island,29634,2530,2530,0,9/10/2020 13:04,6/30/2022 12:30
740,2001-02-16,Thomasville,South Carolina,29634,1725,2025,300,9/10/2020 13:04,6/30/2022 9:40
741,1985-01-12,Thomasville,South Dakota,29634,4505,4505,0,9/10/2020 13:04,4/15/2022 20:50
742,1989-12-17,Thomasville,Tennessee,29634,1860,1860,0,9/10/2020 13:06,3/21/2022 19:28
743,2005-03-03,Vero Beach,Florida,32963,675,1025,350,9/10/2020 13:06,4/28/2021 14:33
744,1954-09-05,Thomasville,Texas,29634,2700,2700,0,9/10/2020 13:07,3/1/2022 12:01
745,2000-07-21,Thomasville,Utah,29634,790,790,0,9/10/2020 13:07,5/8/2021 18:02
746,2001-06-24,Thomasville,Vermont,29634,4060,4060,0,9/10/2020 13:07,6/30/2022 22:40
747,1998-12-29,Thomasville,Virginia,29634,1200,1200,0,9/10/2020 13:07,1/23/2022 10:53
748,1993-01-27,Thomasville,Washington,29634,3620,3620,0,9/10/2020 13:07,5/2/2022 10:03
749,1999-05-27,Thomasville,West Virginia,29634,1380,2580,1200,9/10/2020 13:08,4/15/2022 19:09
750,1966-04-10,Thomasville,Wisconsin,29634,1010,1510,500,9/10/2020 13:09,4/8/2022 17:59
751,1999-07-25,Thomasville,Wyoming,29634,6740,9240,2500,9/10/2020 13:10,1/18/2022 18:15
752,1950-05-23,Thomasville,Alabama,29634,3100,3100,0,9/10/2020 13:10,3/15/2022 0:01
753,1951-09-23,Thomasville,Alaska,29634,4360,4360,0,9/10/2020 13:11,8/31/2021 19:01
754,1973-10-08,Thomasville,Arizona,29634,1360,1360,0,9/10/2020 13:11,1/22/2022 19:34
755,2001-11-01,Thomasville,Arkansas,29634,1460,1460,0,9/10/2020 13:12,4/16/2022 17:35
756,1997-05-23,Thomasville,California,29634,2705,2705,0,9/10/2020 13:12,5/9/2022 18:59
757,1955-03-06,Thomasville,Colorado,29634,550,550,0,9/10/2020 13:13,
758,1957-08-08,Thomasville,Connecticut,29634,930,930,0,9/10/2020 13:13,5/10/2021 17:30
759,1994-10-01,Thomasville,Delaware,29634,650,650,0,9/10/2020 13:13,12/9/2021 14:00
760,1978-11-12,Thomasville,District of Columbia,29634,750,750,0,9/10/2020 13:13,1/22/2022 18:58
761,1973-07-18,Thomasville,Florida,29634,700,700,0,9/10/2020 13:13,
762,1984-07-13,Thomasville,Georgia,29634,900,900,0,9/10/2020 13:13,
763,1969-03-21,Thomasville,Hawaii,29634,300,800,500,9/10/2020 13:14,2/19/2022 17:46
764,1980-12-04,Thomasville,Idaho,29634,1910,1910,0,9/10/2020 13:14,6/13/2022 10:36
765,1979-04-24,Thomasville,Illinois,29634,2120,2120,0,9/10/2020 13:14,12/31/2021 12:21
766,1988-02-07,Thomasville,Indiana,29634,2170,2170,0,9/10/2020 13:14,4/19/2022 15:53
767,1989-01-12,Thomasville,Iowa,29634,2450,2450,0,9/10/2020 13:15,12/20/2021 19:34
768,1997-05-01,Thomasville,Kansas,29634,2125,2125,0,9/10/2020 13:15,3/19/2022 16:00
769,1986-07-20,Winston-Salem,North Carolina,27109,1310,1320,10,9/10/2020 13:15,6/23/2022 7:03
770,1971-09-25,Thomasville,Kentucky,29634,1950,1950,0,9/10/2020 13:15,3/2/2022 21:05
771,2000-07-27,Thomasville,Louisiana,29634,7540,8040,500,9/10/2020 13:16,5/12/2022 17:05
772,2000-03-15,Winston-Salem,North Carolina,27106,2805,3005,200,9/10/2020 13:16,4/12/2022 8:33
773,1976-07-08,Thomasville,Maine,29634,2840,3140,300,9/10/2020 13:16,6/18/2022 12:20
774,1978-12-10,Thomasville,Maryland,29634,3430,3930,500,9/10/2020 13:17,4/16/2022 21:01
775,1968-10-15,Thomasville,Massachusetts,29634,2720,2720,0,9/10/2020 13:17,5/11/2022 17:40
776,2005-12-06,Thomasville,Michigan,29634,1100,1100,0,9/10/2020 13:17,
777,1987-07-04,Thomasville,Minnesota,29634,1090,1090,0,9/10/2020 13:18,4/14/2022 11:05
778,1973-04-06,Thomasville,Mississippi,29634,5680,5680,0,9/10/2020 13:18,4/18/2022 18:01
779,2000-10-25,Thomasville,Missouri,29634,3210,3210,0,9/10/2020 13:18,6/30/2022 19:40
780,1998-07-17,Thomasville,Montana,29634,5490,5490,0,9/10/2020 13:19,4/22/2022 15:51
781,1964-04-01,Thomasville,Nebraska,29634,815,1315,500,9/10/2020 13:19,1/12/2022 17:52
782,2021-12-21,Thomasville,Nevada,29634,4900,5500,600,9/10/2020 13:24,4/11/2022 20:10
783,1977-01-22,Thomasville,New Hampshire,29634,3130,3130,0,9/10/2020 13:26,4/19/2022 21:35
784,1954-03-20,Thomasville,New Jersey,29634,2220,2520,300,9/10/2020 13:26,4/1/2022 11:41
785,2000-01-22,Thomasville,New Mexico,29634,4840,4840,0,9/10/2020 13:27,6/30/2022 14:15
786,1999-07-21,Thomasville,New York,29634,5505,6505,1000,9/10/2020 13:30,3/2/2022 21:04
787,2001-02-03,Thomasville,North Carolina,29634,2480,2480,0,9/10/2020 13:35,4/19/2022 8:18
788,2001-12-10,Thomasville,North Dakota,29634,1895,1895,0,9/10/2020 13:40,6/6/2022 10:20
789,2004-06-09,Thomasville,Ohio,29634,1190,1190,0,9/10/2020 13:43,4/29/2022 13:07
790,1979-02-25,Thomasville,Oklahoma,29634,3380,3880,500,9/10/2020 13:48,4/20/2022 16:33
791,2001-07-23,Thomasville,Oregon,29634,1900,1900,0,9/10/2020 13:49,2/15/2022 19:45
792,2002-12-17,Thomasville,Pennsylvania,29634,4510,5010,500,9/10/2020 13:49,3/4/2022 12:00
793,2002-10-09,Thomasville,Rhode Island,29634,1200,1200,0,9/10/2020 13:49,
794,1996-11-20,Thomasville,South Carolina,29634,6150,6150,0,9/10/2020 13:50,5/2/2022 10:01
795,1993-06-13,Thomasville,South Dakota,29634,2710,3210,500,9/10/2020 13:50,3/2/2022 22:42
796,1971-11-16,Thomasville,Tennessee,29634,2415,2415,0,9/10/2020 13:50,3/31/2022 18:18
797,1990-08-21,Thomasville,Texas,29634,6450,6450,0,9/10/2020 13:51,6/30/2022 9:39
798,2001-02-10,Summit,New Jersey,7901,4075,4275,200,9/10/2020 13:51,4/28/2022 18:42
799,1977-10-23,Thomasville,Utah,29634,1075,1075,0,9/10/2020 13:51,
800,1958-05-14,Thomasville,Vermont,29634,3275,3275,0,9/10/2020 13:51,6/30/2022 17:05
801,1955-09-22,Thomasville,Virginia,29634,6825,6825,0,9/10/2020 13:51,3/25/2022 0:00
802,1973-05-07,Thomasville,Washington,29634,625,625,0,9/10/2020 13:51,3/15/2022 19:01
803,1983-08-04,Thomasville,West Virginia,29634,1370,1370,0,9/10/2020 13:51,3/2/2022 14:59
804,2000-09-14,Thomasville,Wisconsin,29634,6280,6280,0,9/10/2020 13:53,4/16/2022 16:31
805,1978-03-18,Thomasville,Wyoming,29634,2540,2540,0,9/10/2020 13:53,4/18/2022 18:15
806,1967-05-24,Thomasville,Alabama,29634,880,880,0,9/10/2020 13:54,5/2/2021 19:53
807,2001-02-03,Downers Grove,Illinois,60515,1595,2170,575,9/10/2020 13:54,3/24/2022 18:04
808,1981-05-18,Thomasville,Alaska,29634,3105,3105,0,9/10/2020 13:54,6/30/2022 17:24
809,1958-02-26,Thomasville,Arizona,29634,450,950,500,9/10/2020 13:55,5/13/2021 11:55
810,1992-04-25,Thomasville,Arkansas,29634,2335,2335,0,9/10/2020 13:56,1/28/2022 17:36
811,1958-11-10,Thomasville,California,29634,1050,1050,0,9/10/2020 13:56,10/23/2020 12:01
812,1975-12-23,Thomasville,Colorado,29634,3145,3145,0,9/10/2020 13:56,4/30/2022 17:30
813,1995-06-17,Thomasville,Connecticut,29634,1770,1770,0,9/10/2020 13:56,12/7/2021 14:50
814,1998-05-11,Thomasville,Delaware,29634,2890,3190,300,9/10/2020 13:56,3/10/2022 16:52
815,2002-05-11,Thomasville,District of Columbia,29634,3875,3875,0,9/10/2020 13:56,3/25/2022 14:53
816,1966-11-04,Mooresville,North Carolina,28117,4440,4480,40,9/10/2020 13:56,3/23/2022 9:42
817,1956-07-20,Thomasville,Florida,29634,2055,2055,0,9/10/2020 13:58,2/26/2022 22:52
818,1969-11-23,Thomasville,Georgia,29634,860,1360,500,9/10/2020 13:59,5/11/2022 22:00
819,1984-10-12,Thomasville,Hawaii,29634,2960,2960,0,9/10/2020 13:59,3/2/2022 21:45
820,1994-05-24,Thomasville,Idaho,29634,820,820,0,9/10/2020 14:00,5/11/2022 13:14
821,1954-08-22,Thomasville,Illinois,29634,1180,1180,0,9/10/2020 14:00,4/15/2022 20:00
822,1957-12-25,Thomasville,Indiana,29634,1100,1100,0,9/10/2020 14:00,3/29/2022 16:09
823,2001-10-04,Thomasville,Iowa,29634,3285,3285,0,9/10/2020 14:00,4/8/2022 21:54
824,2000-09-19,Terrace Park,Ohio,45174,6440,6440,0,9/10/2020 14:00,5/27/2022 15:42
825,1980-08-08,Thomasville,Kansas,29634,3400,3400,0,9/10/2020 14:00,4/15/2022 1:15
826,1973-07-06,Thomasville,Kentucky,29634,700,700,0,9/10/2020 14:01,1/12/2022 11:03
827,2002-06-06,Lutherville,Maryland,21093,600,1100,500,9/10/2020 14:01,1/22/2022 19:29
828,1987-09-20,Thomasville,Louisiana,29634,915,915,0,9/10/2020 14:01,3/1/2021 15:04
829,2002-03-19,Thomasville,Maine,29634,1460,1760,300,9/10/2020 14:02,4/18/2022 18:02
830,1974-04-26,Thomasville,Maryland,29634,1670,1670,0,9/10/2020 14:02,4/10/2022 16:56
831,1975-09-09,Thomasville,Massachusetts,29634,6280,6880,600,9/10/2020 14:02,6/21/2022 21:33
832,1953-01-16,Thomasville,Michigan,29634,1480,1480,0,9/10/2020 14:02,2/18/2022 16:49
833,1988-06-04,Thomasville,Minnesota,29634,1070,1070,0,9/10/2020 14:02,4/18/2022 11:48
834,1990-02-04,Winston-Salem,North Carolina,27106,80,2305,2225,9/10/2020 14:02,6/7/2021 11:46
835,1994-01-27,Thomasville,Mississippi,29634,1400,2400,1000,9/10/2020 14:02,3/2/2022 20:37
836,2000-03-26,Thomasville,Missouri,29634,2750,3750,1000,9/10/2020 14:02,3/18/2022 11:13
837,1995-05-19,Thomasville,Montana,29634,1290,1290,0,9/10/2020 14:02,4/11/2022 14:01
838,1951-06-06,Thomasville,Nebraska,29634,1150,1150,0,9/10/2020 14:03,3/1/2021 13:17
839,1966-06-17,Thomasville,Nevada,29634,770,770,0,9/10/2020 14:04,5/26/2022 20:06
840,2000-09-29,Thomasville,New Hampshire,29634,7645,7645,0,9/10/2020 14:04,4/6/2022 8:31
841,1975-03-10,Thomasville,New Jersey,29634,200,1100,900,9/10/2020 14:04,
842,1953-10-22,Thomasville,New Mexico,29634,5225,5225,0,9/10/2020 14:05,4/25/2022 17:56
843,2005-11-06,Thomasville,New York,29634,6110,6110,0,9/10/2020 14:05,3/19/2022 0:08
844,1993-11-14,Thomasville,North Carolina,29634,3015,3015,0,9/10/2020 14:06,5/11/2022 13:06
845,1980-10-05,Thomasville,North Dakota,29634,1700,1700,0,9/10/2020 14:06,1/10/2022 17:30
846,1954-01-21,Thomasville,Ohio,29634,2190,2190,0,9/10/2020 14:07,4/11/2022 8:09
847,1965-07-22,Thomasville,Oklahoma,29634,6745,6745,0,9/10/2020 14:07,4/16/2022 18:24
848,1961-09-11,Thomasville,Oregon,29634,500,500,0,9/10/2020 14:07,11/27/2021 20:00
849,1959-01-12,Thomasville,Pennsylvania,29634,1370,1370,0,9/10/2020 14:07,4/16/2022 16:03
850,1981-10-12,Thomasville,Rhode Island,29634,6070,6070,0,9/10/2020 14:07,6/29/2022 20:43
851,1975-04-05,Thomasville,South Carolina,29634,950,950,0,9/10/2020 14:07,2/26/2021 19:29
852,1961-02-01,Thomasville,South Dakota,29634,8720,8720,0,9/10/2020 14:08,6/8/2022 15:19
853,1951-05-08,Thomasville,Tennessee,29634,650,1250,600,9/10/2020 14:08,9/15/2021 20:00
854,1964-07-01,Thomasville,Texas,29634,1100,1100,0,9/10/2020 14:08,3/28/2022 10:52
855,1962-04-24,Thomasville,Utah,29634,800,800,0,9/10/2020 14:08,
856,2002-01-21,Winston-Salem,North Carolina,27106,210,910,700,9/10/2020 14:09,5/10/2021 14:43
857,1989-02-13,McLean,Virginia,22101,1050,1450,400,9/10/2020 14:09,2/18/2022 9:03
858,1974-07-28,Thomasville,Vermont,29634,3620,4120,500,9/10/2020 14:09,6/23/2022 11:54
859,1974-01-01,Thomasville,Virginia,29634,2575,3575,1000,9/10/2020 14:09,5/29/2022 14:23
860,1992-07-28,Thomasville,Washington,29634,760,760,0,9/10/2020 14:10,4/8/2022 18:01
861,1962-09-21,Thomasville,West Virginia,29634,2490,2490,0,9/10/2020 14:10,4/8/2022 13:02
862,1986-06-23,Thomasville,Wisconsin,29634,1000,1000,0,9/10/2020 14:10,1/31/2022 20:10
863,1992-07-19,Thomasville,Wyoming,29634,820,820,0,9/10/2020 14:10,5/3/2021 13:43
864,1995-06-23,Thomasville,Alabama,29634,200,700,500,9/10/2020 14:10,1/23/2022 0:34
865,1999-02-14,Thomasville,Alaska,29634,3530,3530,0,9/10/2020 14:10,3/25/2022 19:38
866,1976-10-13,Thomasville,Arizona,29634,6145,6145,0,9/10/2020 14:10,4/20/2022 16:41
867,2002-09-16,Thomasville,Arkansas,29634,6025,6025,0,9/10/2020 14:10,4/8/2022 17:58
868,1968-08-27,Thomasville,California,29634,7780,8080,300,9/10/2020 14:11,4/8/2022 2:09
869,1960-02-22,Thomasville,Colorado,29634,2800,2800,0,9/10/2020 14:11,3/2/2022 20:53
870,1999-06-14,Thomasville,Connecticut,29634,2270,2770,500,9/10/2020 14:11,4/14/2022 21:20
871,1951-07-14,Thomasville,Delaware,29634,5905,5905,0,9/10/2020 14:11,5/9/2022 18:00
872,2003-11-18,Thomasville,District of Columbia,29634,1600,1600,0,9/10/2020 14:11,1/22/2022 16:39
873,1992-07-08,Thomasville,Florida,29634,1350,1350,0,9/10/2020 14:11,11/25/2021 2:27
874,1964-06-08,Winston-Salem,Connecticut,27109,15140,15490,350,9/10/2020 14:11,5/3/2022 11:30
875,1980-08-27,Thomasville,Georgia,29634,1050,1050,0,9/10/2020 14:12,11/18/2021 17:53
876,1999-02-01,Thomasville,Hawaii,29634,1050,1050,0,9/10/2020 14:12,5/3/2022 15:22
877,1979-10-08,Thomasville,Idaho,29634,1230,1230,0,9/10/2020 14:12,3/13/2022 22:15
878,1972-10-25,Thomasville,Illinois,29634,2455,2755,300,9/10/2020 14:12,9/10/2021 20:28
879,1988-12-27,Thomasville,Indiana,29634,1470,1470,0,9/10/2020 14:12,5/4/2022 14:27
880,1963-08-27,Thomasville,Iowa,29634,1300,1800,500,9/10/2020 14:12,3/12/2022 17:11
881,1953-09-16,Thomasville,Kansas,29634,900,900,0,9/10/2020 14:12,1/12/2022 19:17
882,1975-05-26,Thomasville,Kentucky,29634,430,430,0,9/10/2020 14:13,2/25/2022 20:06
883,1964-07-18,Thomasville,Louisiana,29634,665,2665,2000,9/10/2020 14:13,4/22/2022 0:43
884,2003-05-26,Thomasville,Maine,29634,1590,1590,0,9/10/2020 14:13,4/18/2022 16:23
885,1987-11-08,Thomasville,Maryland,29634,2875,2875,0,9/10/2020 14:13,4/9/2022 11:07
886,1994-08-08,Thomasville,Massachusetts,29634,2650,2650,0,9/10/2020 14:13,3/25/2022 18:19
887,1975-01-17,Thomasville,Michigan,29634,1260,1260,0,9/10/2020 14:14,5/5/2022 19:36
888,1968-07-23,Thomasville,Minnesota,29634,1150,1150,0,9/10/2020 14:14,3/18/2022 16:06
889,1959-12-15,Thomasville,Mississippi,29634,800,800,0,9/10/2020 14:14,3/25/2022 18:01
890,1969-08-08,Thomasville,Missouri,29634,450,750,300,9/10/2020 14:14,6/2/2022 22:14
891,1957-07-02,Thomasville,Montana,29634,4950,4950,0,9/10/2020 14:15,1/22/2022 22:02
892,1981-09-14,Thomasville,Nebraska,29634,1200,1200,0,9/10/2020 14:15,
893,1997-08-06,Thomasville,Nevada,29634,1370,1370,0,9/10/2020 14:15,4/15/2022 9:26
894,1989-09-25,Thomasville,New Hampshire,29634,1400,1400,0,9/10/2020 14:15,3/27/2022 22:28
895,1996-04-11,Thomasville,New Jersey,29634,1560,1560,0,9/10/2020 14:15,4/20/2022 20:05
896,2001-10-04,Thomasville,New Mexico,29634,900,900,0,9/10/2020 14:16,1/28/2022 18:28
897,1974-08-04,Thomasville,New York,29634,1310,1310,0,9/10/2020 14:16,4/15/2022 22:37
898,1991-09-03,Thomasville,North Carolina,29634,2020,2020,0,9/10/2020 14:16,4/15/2022 17:29
899,1994-04-26,Thomasville,North Dakota,29634,880,880,0,9/10/2020 14:16,12/9/2021 10:33
900,1987-11-13,Thomasville,Ohio,29634,2650,2650,0,9/10/2020 14:17,4/28/2022 0:41
901,1955-07-15,Thomasville,Oklahoma,29634,2860,2860,0,9/10/2020 14:17,4/11/2022 18:18
902,1961-05-12,Thomasville,Oregon,29634,1050,1050,0,9/10/2020 14:17,3/30/2022 16:03
903,1969-03-25,Anthem,Arizona,85086,870,1070,200,9/10/2020 14:17,1/12/2022 19:16
904,1982-11-10,Thomasville,Pennsylvania,29634,1350,1850,500,9/10/2020 14:17,3/2/2022 20:31
905,1998-08-20,Thomasville,Rhode Island,29634,1020,1020,0,9/10/2020 14:18,6/8/2022 0:27
906,2021-04-25,Thomasville,South Carolina,29634,2040,2040,0,9/10/2020 14:18,6/30/2022 14:10
907,2002-02-26,Thomasville,South Dakota,29634,4275,4275,0,9/10/2020 14:19,5/3/2022 13:01
908,1995-04-03,Thomasville,Tennessee,29634,1150,1150,0,9/10/2020 14:19,1/29/2022 12:31
909,2000-05-22,Thomasville,Texas,29634,6815,9115,2300,9/10/2020 14:19,6/30/2022 13:07
910,1955-01-09,Thomasville,Utah,29634,500,1000,500,9/10/2020 14:19,4/5/2022 19:03
911,1955-01-11,Thomasville,Vermont,29634,2770,2770,0,9/10/2020 14:19,5/11/2022 20:50
912,1976-06-27,Thomasville,Virginia,29634,2205,2205,0,9/10/2020 14:19,3/13/2022 22:23
913,1996-08-13,Thomasville,Washington,29634,810,1310,500,9/10/2020 14:19,2/24/2022 13:31
914,2002-04-26,Thomasville,West Virginia,29634,4785,4785,0,9/10/2020 14:20,4/14/2022 21:04
915,1963-01-10,Thomasville,Wisconsin,29634,1510,1510,0,9/10/2020 14:20,4/27/2022 9:04
916,1973-09-28,Thomasville,Wyoming,29634,675,675,0,9/10/2020 14:20,10/14/2020 10:18
917,1999-03-09,Thomasville,Alabama,29634,200,500,300,9/10/2020 14:21,
918,1990-03-03,Thomasville,Alaska,29634,4670,4670,0,9/10/2020 14:21,5/8/2022 1:13
919,2003-09-19,Thomasville,Arizona,29634,1710,1710,0,9/10/2020 14:21,3/1/2022 15:38
920,2002-03-15,Thomasville,Arkansas,29634,1460,1460,0,9/10/2020 14:21,5/6/2022 12:04
921,1986-04-18,Thomasville,California,29634,1750,1750,0,9/10/2020 14:22,3/5/2022 12:15
922,2000-12-12,Thomasville,Colorado,29634,2150,2150,0,9/10/2020 14:22,1/22/2022 19:17
923,1981-01-17,Thomasville,Connecticut,29634,960,960,0,9/10/2020 14:22,5/12/2022 13:58
924,1960-09-16,Thomasville,Delaware,29634,2285,2285,0,9/10/2020 14:22,1/12/2022 18:02
925,1993-09-02,Thomasville,District of Columbia,29634,2105,2905,800,9/10/2020 14:22,5/26/2022 22:04
926,1999-10-21,Thomasville,Florida,29634,660,960,300,9/10/2020 14:23,4/29/2022 16:06
927,1971-08-24,Thomasville,Georgia,29634,1460,1460,0,9/10/2020 14:23,6/4/2022 0:57
928,1990-03-25,Thomasville,Hawaii,29634,970,970,0,9/10/2020 14:24,5/16/2021 19:32
929,1986-04-11,Thomasville,Idaho,29634,2120,2120,0,9/10/2020 14:25,3/2/2022 18:24
930,1999-11-01,Thomasville,Illinois,29634,2160,2160,0,9/10/2020 14:25,4/18/2022 18:01
931,1979-08-22,Thomasville,Indiana,29634,4200,4200,0,9/10/2020 14:25,5/10/2022 20:31
932,1977-05-05,Thomasville,Iowa,29634,900,900,0,9/10/2020 14:25,3/20/2022 3:20
933,1953-07-28,Thomasville,Kansas,29634,3600,3600,0,9/10/2020 14:25,3/19/2022 15:36
934,2005-12-20,Chevy Chase ,Maryland,20815,265,1840,1575,9/10/2020 14:26,5/8/2021 13:53
935,1981-11-14,Thomasville,Kentucky,29634,600,1100,500,9/10/2020 14:26,3/2/2022 15:35
936,2002-01-16,Thomasville,Louisiana,29634,2000,2000,0,9/10/2020 14:26,6/30/2022 17:12
937,2000-04-08,Thomasville,Maine,29634,310,810,500,9/10/2020 14:26,4/14/2022 18:12
938,2002-09-10,Thomasville,Maryland,29634,1760,1760,0,9/10/2020 14:26,2/27/2022 21:14
939,1992-03-24,Thomasville,Massachusetts,29634,1980,1980,0,9/10/2020 14:26,6/1/2022 23:55
940,1992-11-21,Thomasville,Michigan,29634,830,830,0,9/10/2020 14:26,5/2/2021 18:51
941,1953-04-22,Thomasville,Minnesota,29634,660,660,0,9/10/2020 14:26,4/9/2022 14:45
942,1950-12-26,Harrison,Alabama,37341,2820,2830,10,9/10/2020 14:27,1/22/2022 20:57
943,1959-10-10,Thomasville,Mississippi,29634,930,930,0,9/10/2020 14:27,9/28/2021 7:39
944,1982-07-12,Thomasville,Missouri,29634,1940,2940,1000,9/10/2020 14:27,6/29/2022 15:15
945,1969-01-05,Thomasville,Montana,29634,4780,4780,0,9/10/2020 14:28,5/9/2022 18:04
946,1976-05-11,Thomasville,Nebraska,29634,2690,2690,0,9/10/2020 14:28,5/11/2022 17:49
947,1976-06-08,Thomasville,Nevada,29634,600,600,0,9/10/2020 14:28,
948,2005-01-14,Thomasville,New Hampshire,29634,850,850,0,9/10/2020 14:28,3/25/2022 22:31
949,1984-03-05,Thomasville,New Jersey,29634,1840,1840,0,9/10/2020 14:29,1/12/2022 18:08
950,1953-11-08,Thomasville,New Mexico,29634,2030,2030,0,9/10/2020 14:29,4/10/2022 16:21
951,1985-11-19,Thomasville,New York,29634,920,1420,500,9/10/2020 14:29,4/29/2022 16:04
952,1961-05-14,Thomasville,North Carolina,29634,2110,2110,0,9/10/2020 14:29,3/26/2022 22:45
953,1977-11-05,Thomasville,North Dakota,29634,920,920,0,9/10/2020 14:30,3/2/2022 19:38
954,1975-02-15,Thomasville,Ohio,29634,1110,1110,0,9/10/2020 14:30,1/22/2022 18:56
955,1986-01-20,Thomasville,Oklahoma,29634,8060,8060,0,9/10/2020 14:30,2/26/2022 13:54
956,1986-11-06,Thomasville,Oregon,29634,550,550,0,9/10/2020 14:30,2/19/2022 23:55
957,1952-11-26,Thomasville,Pennsylvania,29634,1920,1920,0,9/10/2020 14:30,1/25/2022 19:00
958,1978-05-04,Thomasville,Rhode Island,29634,1520,1520,0,9/10/2020 14:31,3/30/2022 11:01
959,2001-11-21,Thomasville,South Carolina,29634,700,700,0,9/10/2020 14:31,3/6/2022 20:07
960,1954-09-10,Thomasville,South Dakota,29634,610,610,0,9/10/2020 14:31,11/4/2021 14:39
961,1993-11-18,Thomasville,Tennessee,29634,1470,1470,0,9/10/2020 14:31,5/7/2021 10:42
962,1994-02-02,Thomasville,Texas,29634,2430,2430,0,9/10/2020 14:32,4/8/2022 12:17
963,1972-06-01,Thomasville,Utah,29634,1150,1150,0,9/10/2020 14:32,4/2/2022 14:14
964,1962-08-21,Thomasville,Vermont,29634,3990,3990,0,9/10/2020 14:32,3/13/2022 22:52
965,1956-08-18,Thomasville,Virginia,29634,3110,3110,0,9/10/2020 14:32,2/26/2022 18:23
966,1969-04-13,Thomasville,Washington,29634,1910,4460,2550,9/10/2020 14:32,5/20/2022 11:12
967,1956-05-22,Thomasville,West Virginia,29634,3530,3530,0,9/10/2020 14:32,4/10/2022 15:37
968,1993-07-27,Thomasville,Wisconsin,29634,460,460,0,9/10/2020 14:33,6/3/2022 16:38
969,2002-02-11,Thomasville,Wyoming,29634,820,820,0,9/10/2020 14:33,3/30/2022 15:40
970,2002-03-10,Thomasville,Alabama,29634,2080,2080,0,9/10/2020 14:34,4/18/2022 10:57
971,1955-07-26,Thomasville,Alaska,29634,1990,1990,0,9/10/2020 14:34,12/18/2021 8:39
972,1966-05-16,Thomasville,Arizona,29634,1920,1920,0,9/10/2020 14:34,12/11/2021 20:09
973,1989-10-03,Thomasville,Arkansas,29634,3425,6425,3000,9/10/2020 14:34,5/31/2022 11:52
974,1998-10-20,Winston-Salem,North Carolina,27109,790,1890,1100,9/10/2020 14:34,3/12/2022 10:48
975,1960-12-10,Thomasville,California,29634,760,1260,500,9/10/2020 14:35,4/8/2022 12:02
976,1959-03-05,Thomasville,Colorado,29634,500,500,0,9/10/2020 14:35,10/12/2021 15:14
977,1969-03-18,Thomasville,Connecticut,29634,500,500,0,9/10/2020 14:36,
978,1960-05-02,Thomasville,Delaware,29634,2410,2910,500,9/10/2020 14:36,5/3/2022 17:57
979,1993-06-09,Thomasville,District of Columbia,29634,850,1150,300,9/10/2020 14:37,3/2/2022 19:35
980,1957-06-25,Thomasville,Florida,29634,60,560,500,9/10/2020 14:37,4/15/2022 14:01
981,1971-03-28,Winston-Salem,North Carolina,27106,760,810,50,9/10/2020 14:37,11/13/2020 12:42
982,1985-10-09,Thomasville,Georgia,29634,1160,1660,500,9/10/2020 14:37,3/15/2022 22:35
983,1977-11-27,Thomasville,Hawaii,29634,800,800,0,9/10/2020 14:37,11/13/2020 16:24
984,1972-11-05,Thomasville,Idaho,29634,1700,1700,0,9/10/2020 14:38,2/17/2022 13:25
985,1978-04-26,Thomasville,Illinois,29634,3800,3800,0,9/10/2020 14:38,5/8/2022 9:42
986,1994-02-05,Thomasville,Indiana,29634,2700,2700,0,9/10/2020 14:40,3/16/2022 18:38
987,1956-10-19,Thomasville,Iowa,29634,2980,2980,0,9/10/2020 14:41,3/13/2022 22:15
988,1969-03-17,Thomasville,Kansas,29634,400,400,0,9/10/2020 14:41,1/7/2021 17:32
989,1974-07-12,Thomasville,Kentucky,29634,730,730,0,9/10/2020 14:47,
990,1982-09-18,Thomasville,Louisiana,29634,1350,1350,0,9/10/2020 14:49,5/8/2022 23:41
991,1964-07-03,Thomasville,Maine,29634,1250,1250,0,9/10/2020 14:50,1/22/2022 17:52
992,2000-12-06,Scituate,Massachusetts,2066,1405,1480,75,9/10/2020 14:51,1/2/2022 18:39
993,1983-12-18,Thomasville,Maryland,29634,850,850,0,9/10/2020 14:51,2/12/2022 14:45
994,1992-08-20,Thomasville,Massachusetts,29634,8220,8220,0,9/10/2020 14:52,3/19/2022 14:16
995,1971-04-26,Thomasville,Michigan,29634,1260,1260,0,9/10/2020 14:54,2/26/2022 19:53
996,1979-03-11,Thomasville,Minnesota,29634,575,1075,500,9/10/2020 14:55,1/12/2022 18:08
997,1961-09-22,Smyrna,Georgia,30080,725,755,30,9/10/2020 14:56,4/16/2022 12:43
998,1990-09-25,Thomasville,Mississippi,29634,780,780,0,9/10/2020 14:56,1/13/2022 3:11
999,1965-03-27,Thomasville,Missouri,29634,3950,4350,400,9/10/2020 14:56,6/25/2022 0:54
1000,2001-09-24,Wyckoff,New Jersey,7481,6530,6830,300,9/10/2020 14:56,6/30/2022 17:12
1001,1970-12-14,Thomasville,Montana,29634,2140,2140,0,9/10/2020 14:56,7/1/2022 8:32
1002,2002-07-03,Thomasville,Nebraska,29634,700,700,0,9/10/2020 14:56,
1003,1987-06-19,Thomasville,Nevada,29634,1580,1880,300,9/10/2020 14:57,5/26/2022 21:58
1004,1957-12-08,Thomasville,New Hampshire,29634,610,610,0,9/10/2020 14:59,4/19/2022 18:49
1005,1998-12-09,Winston-Salem,North Carolina,27106,4985,5085,100,9/10/2020 15:00,5/11/2022 18:49
1006,1974-07-25,Thomasville,New Jersey,29634,515,815,300,9/10/2020 15:01,2/19/2022 12:24
1007,1997-11-16,Thomasville,New Mexico,29634,610,610,0,9/10/2020 15:01,4/19/2022 19:30
1008,1974-08-24,Thomasville,New York,29634,500,500,0,9/10/2020 15:02,
1009,1957-09-23,Thomasville,North Carolina,29634,1010,1010,0,9/10/2020 15:02,4/30/2021 14:06
1010,2002-02-11,Thomasville,North Dakota,29634,1070,1070,0,9/10/2020 15:02,2/2/2022 13:01
1011,1969-01-10,Thomasville,Ohio,29634,1860,1860,0,9/10/2020 15:03,2/19/2022 12:33
1012,1962-06-19,Thomasville,Oklahoma,29634,1880,1880,0,9/10/2020 15:03,5/31/2022 21:52
1013,1965-07-16,Thomasville,Oregon,29634,100,600,500,9/10/2020 15:03,2/12/2022 15:08
1014,1957-10-05,Thomasville,Pennsylvania,29634,890,890,0,9/10/2020 15:06,5/9/2022 22:30
1015,1998-03-13,Thomasville,Rhode Island,29634,1550,1550,0,9/10/2020 15:06,11/30/2021 18:18
1016,1996-07-27,Thomasville,South Carolina,29634,700,700,0,9/10/2020 15:06,11/24/2021 16:42
1017,1991-09-26,Thomasville,South Dakota,29634,500,500,0,9/10/2020 15:12,
1018,1975-01-02,Thomasville,Tennessee,29634,2070,3070,1000,9/10/2020 15:15,1/11/2022 20:12
1019,1985-01-15,Thomasville,Texas,29634,830,1830,1000,9/10/2020 15:15,4/10/2022 18:04
1020,1997-06-27,Thomasville,Utah,29634,330,830,500,9/10/2020 15:19,5/6/2022 17:41
1021,1990-11-18,Sandy springs,Georgia,30328,250,550,300,9/10/2020 15:20,3/21/2022 20:04
1022,1999-06-20,Thomasville,Vermont,29634,650,650,0,9/10/2020 15:22,1/12/2022 18:46
1023,1996-05-22,Thomasville,Virginia,29634,1075,1875,800,9/10/2020 15:23,4/19/2022 15:46
1024,2001-06-07,Thomasville,Washington,29634,3850,4150,300,9/10/2020 15:23,7/1/2022 7:47
1025,2002-08-22,Thomasville,West Virginia,29634,95,4595,4500,9/10/2020 15:25,6/25/2022 0:00
1026,1957-08-26,Thomasville,Wisconsin,29634,1560,1560,0,9/10/2020 15:31,2/18/2022 14:33
1027,1983-07-24,Thomasville,Wyoming,29634,1800,1800,0,9/10/2020 15:31,2/26/2022 18:00
1028,1967-10-15,Thomasville,Alabama,29634,2025,2025,0,9/10/2020 15:36,1/12/2022 17:20
1029,1998-07-29,Thomasville,Alaska,29634,1900,1900,0,9/10/2020 15:37,6/10/2021 3:26
1030,1971-05-06,Thomasville,Arizona,29634,850,850,0,9/10/2020 15:37,10/30/2021 16:40
1031,1963-02-09,Thomasville,Arkansas,29634,910,910,0,9/10/2020 15:38,1/22/2022 19:39
1032,1957-12-27,Thomasville,California,29634,960,960,0,9/10/2020 15:38,3/14/2022 9:52
1033,1984-08-12,Thomasville,Colorado,29634,925,925,0,9/10/2020 15:39,6/20/2022 8:55
1034,1993-12-21,Thomasville,Connecticut,29634,1200,1200,0,9/10/2020 15:40,4/16/2022 16:12
1035,1981-10-21,Thomasville,Delaware,29634,700,700,0,9/10/2020 15:40,
1036,2004-11-17,Thomasville,District of Columbia,29634,2860,2860,0,9/10/2020 15:43,2/19/2022 13:01
1037,2002-07-26,Thomasville,Florida,29634,1705,1705,0,9/10/2020 15:47,4/5/2022 12:40
1038,1955-12-06,Thomasville,Georgia,29634,2130,2130,0,9/10/2020 15:57,1/22/2022 20:33
1039,1981-09-06,Thomasville,Hawaii,29634,1135,1135,0,9/10/2020 16:14,1/22/2022 19:56
1040,1959-11-12,Raleigh ,North Carolina,27609,490,500,10,9/10/2020 16:21,10/14/2020 13:52
1041,1968-02-03,Thomasville,Idaho,29634,1110,1110,0,9/10/2020 16:21,4/16/2022 12:33
1042,1954-05-08,Thomasville,Illinois,29634,2180,2180,0,9/10/2020 16:32,2/26/2022 19:40
1043,1953-07-14,Thomasville,Indiana,29634,4765,4765,0,9/10/2020 16:51,6/30/2022 19:00
1044,2000-02-12,Mt. Pleasant ,South Carolina,29466,4755,5380,625,9/10/2020 17:04,5/13/2022 9:17
1045,1952-02-28,Thomasville,Iowa,29634,1100,1100,0,9/10/2020 17:06,2/17/2022 21:12
1046,1963-11-01,Thomasville,Kansas,29634,400,400,0,9/10/2020 17:55,10/20/2020 15:18
1047,1959-04-24,Thomasville,Kentucky,29634,3735,4735,1000,9/10/2020 17:57,3/14/2022 9:19
1048,1957-12-13,Thomasville,Louisiana,29634,2010,2010,0,9/10/2020 18:02,4/8/2022 21:52
1049,2002-08-17,Northport,New York,11768,3565,3565,0,9/10/2020 18:04,2/8/2022 6:01
1050,1998-11-13,Thomasville,Maine,29634,1465,1465,0,9/10/2020 18:25,3/3/2022 20:39
1051,2005-01-21,Thomasville,Maryland,29634,12210,14210,2000,9/10/2020 18:27,5/11/2022 17:21
1052,1973-05-16,Thomasville,Massachusetts,29634,710,710,0,9/10/2020 18:59,5/11/2021 13:19
1053,1956-12-27,Thomasville,Michigan,29634,8415,8415,0,9/10/2020 19:00,5/12/2022 13:21
1054,2000-11-02,Pittsburgh,Pennsylvania,15217,5470,6470,1000,9/10/2020 19:21,4/25/2022 20:09
1055,1983-05-21,Thomasville,Minnesota,29634,3690,3690,0,9/10/2020 19:26,3/5/2022 21:05
1056,1998-05-22,Thomasville,Mississippi,29634,400,400,0,9/10/2020 19:40,10/20/2020 20:02
1057,1983-02-16,Chevy Chase,Maryland,20815,750,1250,500,9/10/2020 19:56,3/22/2022 10:19
1058,2002-05-28,Thomasville,Missouri,29634,400,400,0,9/10/2020 19:57,12/4/2021 14:40
1059,1975-12-12,Thomasville,Montana,29634,500,500,0,9/10/2020 19:58,3/13/2022 10:36
1060,1991-02-25,Thomasville,Nebraska,29634,3770,3770,0,9/10/2020 21:03,4/21/2022 14:40
1061,1953-08-25,Thomasville,Nevada,29634,2980,3280,300,9/10/2020 21:11,4/16/2022 16:18
1062,2001-10-15,Thomasville,New Hampshire,29634,3140,3140,0,9/10/2020 21:13,5/3/2022 17:42
1063,2000-06-13,Thomasville,New Jersey,29634,1480,1480,0,9/10/2020 21:35,5/9/2022 18:10
1064,1997-01-18,Thomasville,New Mexico,29634,2530,2530,0,9/10/2020 22:30,3/16/2022 20:13
1065,1952-01-06,Thomasville,New York,29634,2070,2070,0,9/10/2020 22:36,3/15/2022 10:07
1066,1981-04-05,Thomasville,North Carolina,29634,750,750,0,9/10/2020 22:52,10/17/2020 15:46
1067,1969-03-14,Thomasville,North Dakota,29634,1970,2470,500,9/10/2020 23:56,6/25/2022 18:09
1068,1983-02-16,Winston-Salem,North Carolina,27105,610,610,0,9/11/2020 8:52,5/25/2021 8:33
1069,1968-04-05,Thomasville,Ohio,29634,1485,1485,0,9/11/2020 8:58,6/7/2021 20:33
1070,1981-09-18,Thomasville,Oklahoma,29634,2100,2100,0,9/11/2020 8:59,
1071,1979-09-09,Thomasville,Oregon,29634,700,700,0,9/11/2020 9:29,
1072,1973-05-03,Thomasville,Pennsylvania,29634,6335,7335,1000,9/11/2020 10:07,6/21/2022 15:59
1073,1962-09-25,Thomasville,Rhode Island,29634,230,480,250,9/11/2020 10:31,12/1/2021 14:34
1074,1964-05-04,Thomasville,South Carolina,29634,3975,4475,500,9/11/2020 10:35,4/8/2022 22:48
1075,1999-02-24,Thomasville,South Dakota,29634,1320,1320,0,9/11/2020 10:50,2/26/2021 17:07
1076,1975-01-01,Thomasville,Tennessee,29634,1710,1710,0,9/11/2020 10:50,5/14/2022 0:39
1077,1983-03-11,Thomasville,Texas,29634,400,400,0,9/11/2020 10:59,2/25/2022 9:29
1078,1959-08-08,Thomasville,Utah,29634,500,500,0,9/11/2020 12:13,
1079,2002-05-13,Thomasville,Vermont,29634,4380,5380,1000,9/11/2020 14:27,4/21/2022 12:05
1080,1968-04-24,Thomasville,Virginia,29634,3865,4065,200,9/11/2020 14:45,5/23/2021 20:54
1081,1989-07-15,Thomasville,Washington,29634,700,700,0,9/11/2020 15:48,
1082,1986-06-05,Thomasville,West Virginia,29634,1230,1230,0,9/11/2020 16:30,6/2/2022 15:28
1083,1977-01-07,Thomasville,Wisconsin,29634,700,1000,300,9/11/2020 16:50,3/26/2022 20:33
1084,2001-05-17,Thomasville,Wyoming,29634,300,300,0,9/11/2020 17:53,
1085,1969-04-02,Thomasville,Alabama,29634,1125,1125,0,9/11/2020 18:05,2/17/2022 17:05
1086,1971-07-28,Thomasville,Alaska,29634,430,430,0,9/11/2020 18:53,10/20/2020 22:53
1087,2000-05-03,Thomasville,Arizona,29634,2030,2530,500,9/11/2020 19:15,4/16/2022 13:39
1088,1954-03-08,Thomasville,Arkansas,29634,1300,1300,0,9/11/2020 20:19,1/21/2022 21:59
1089,1979-02-12,Thomasville,California,29634,1020,1020,0,9/11/2020 20:31,8/21/2021 14:25
1090,1978-10-05,Thomasville,Colorado,29634,400,400,0,9/11/2020 20:37,
1091,2003-12-08,Thomasville,Connecticut,29634,400,400,0,9/11/2020 20:48,10/31/2020 14:31
1092,1958-11-20,Thomasville,Delaware,29634,1340,1340,0,9/11/2020 20:51,6/13/2022 22:48
1093,1963-02-06,Thomasville,District of Columbia,29634,1170,1170,0,9/11/2020 20:51,5/26/2022 20:22
1094,1970-06-07,Thomasville,Florida,29634,6680,6680,0,9/11/2020 20:52,5/11/2022 18:55
1095,1959-07-24,Thomasville,Georgia,29634,1740,1740,0,9/11/2020 21:10,8/30/2021 10:56
1096,1979-01-02,Thomasville,Hawaii,29634,400,400,0,9/11/2020 21:17,
1097,1958-01-28,Thomasville,Idaho,29634,450,450,0,9/11/2020 21:30,
1098,2001-10-20,Thomasville,Illinois,29634,6330,6330,0,9/11/2020 21:31,6/30/2022 15:14
1099,1989-01-10,Thomasville,Indiana,29634,400,400,0,9/11/2020 22:10,
1100,1995-07-03,Thomasville,Iowa,29634,430,430,0,9/12/2020 0:07,
1101,2000-11-07,Thomasville,Kansas,29634,5880,5880,0,9/12/2020 7:26,4/30/2022 10:04
1102,1999-07-19,Winston-Salem,North Carolina,27106,2330,7830,5500,9/12/2020 8:00,5/28/2021 21:54
1102,1999-07-19,Winston-Salem,North Carolina,27106,2330,7830,5500,9/12/2020 8:00,5/28/2021 21:54
1103,1963-04-15,Thomasville,Kentucky,29634,3915,3915,0,9/12/2020 8:20,4/15/2022 20:01
1104,1965-11-18,Thomasville,Louisiana,29634,500,500,0,9/12/2020 9:38,3/15/2022 16:39
1105,1995-05-25,Thomasville,Maine,29634,920,920,0,9/12/2020 10:14,5/3/2021 13:30
1106,1974-02-22,Thomasville,Maryland,29634,1015,1015,0,9/12/2020 11:28,12/24/2021 12:49
1107,1997-03-07,Thomasville,Massachusetts,29634,5455,5455,0,9/12/2020 12:00,4/27/2022 22:53
1108,1971-10-26,Thomasville,Michigan,29634,30,530,500,9/12/2020 12:58,11/30/2021 18:19
1109,2005-02-28,Thomasville,Minnesota,29634,865,1665,800,9/12/2020 13:22,10/30/2020 18:54
1110,1968-11-28,Thomasville,Mississippi,29634,1420,1420,0,9/12/2020 13:28,3/14/2022 14:17
1111,1996-08-18,Thomasville,Missouri,29634,2990,2990,0,9/12/2020 13:38,4/8/2022 19:40
1112,1978-05-15,Thomasville,Montana,29634,2775,2775,0,9/12/2020 14:14,5/17/2021 23:43
1113,2001-07-11,Thomasville,Nebraska,29634,550,550,0,9/12/2020 14:34,3/24/2022 18:00
1114,1962-02-14,Thomasville,Nevada,29634,530,1030,500,9/12/2020 16:46,1/20/2022 21:09
1115,1970-07-20,Thomasville,New Hampshire,29634,1225,1225,0,9/12/2020 18:17,11/14/2021 7:56
1116,2004-07-02,Thomasville,New Jersey,29634,1800,6300,4500,9/12/2020 18:49,6/30/2022 0:20
1117,1986-07-22,Thomasville,New Mexico,29634,4865,4865,0,9/12/2020 18:53,5/23/2022 15:26
1118,1999-03-05,Thomasville,New York,29634,1785,1785,0,9/12/2020 18:53,5/17/2021 14:08
1119,2001-05-17,Thomasville,North Carolina,29634,1425,1425,0,9/12/2020 19:07,10/28/2021 9:36
1120,1975-08-24,Thomasville,North Dakota,29634,5720,5720,0,9/12/2020 19:23,6/29/2022 18:34
1121,1958-12-06,Thomasville,Ohio,29634,2125,2125,0,9/12/2020 19:24,3/5/2022 15:29
1122,1995-02-14,Thomasville,Oklahoma,29634,1150,1150,0,9/12/2020 19:33,11/10/2021 16:00
1123,1984-08-15,Thomasville,Oregon,29634,8680,9980,1300,9/12/2020 19:45,5/27/2022 21:32
1124,1961-10-06,Thomasville,Pennsylvania,29634,975,975,0,9/12/2020 19:48,3/15/2022 16:36
1125,1992-09-23,Thomasville,Rhode Island,29634,975,975,0,9/12/2020 19:54,
1126,2001-03-20,Thomasville,South Carolina,29634,975,975,0,9/12/2020 19:54,2/19/2022 13:22
1127,1999-10-08,Thomasville,South Dakota,29634,8180,8180,0,9/12/2020 20:33,4/29/2022 16:02
1128,2002-03-01,Thomasville,Tennessee,29634,4925,4925,0,9/12/2020 20:34,3/11/2022 12:17
1129,2000-10-06,Thomasville,Texas,29634,2460,2460,0,9/12/2020 21:01,6/20/2022 14:54
1130,1951-08-04,Thomasville,Utah,29634,2025,2025,0,9/13/2020 13:46,5/6/2022 18:45
1131,1966-11-08,Thomasville,Vermont,29634,130,630,500,9/13/2020 18:56,5/18/2022 2:18
1132,1959-01-15,Thomasville,Virginia,29634,220,620,400,9/14/2020 21:29,4/10/2021 21:04
1133,1976-05-11,Thomasville,Washington,29634,1110,1110,0,9/15/2020 11:21,3/1/2022 1:15
1134,1988-01-15,Thomasville,West Virginia,29634,630,1930,1300,9/16/2020 14:15,4/27/2022 9:14
1135,2000-03-08,Thomasville,Wisconsin,29634,400,400,0,9/16/2020 17:30,1/12/2022 11:07
1136,1956-11-24,Thomasville,Wyoming,29634,670,670,0,9/16/2020 17:37,5/6/2022 8:30
1137,1973-05-01,Thomasville,Alabama,29634,700,700,0,9/16/2020 17:44,
1138,1961-09-21,Thomasville,Alaska,29634,2710,2710,0,9/16/2020 17:45,5/18/2022 15:01
1139,1962-03-10,Winston-Salem,North Carolina,27106,885,1195,310,9/16/2020 17:54,5/1/2021 14:45
1140,2001-10-25,Thomasville,Arizona,29634,4410,5160,750,9/16/2020 17:54,3/25/2022 13:19
1141,1996-05-23,Thomasville,Arkansas,29634,950,950,0,9/16/2020 17:59,
1142,2000-03-26,Thomasville,California,29634,7290,7790,500,9/16/2020 18:05,6/30/2022 9:50
1143,1992-02-17,Thomasville,Colorado,29634,950,950,0,9/16/2020 18:09,10/15/2020 14:57
1144,2001-10-29,Thomasville,Connecticut,29634,6500,6500,0,9/16/2020 18:17,4/18/2022 18:02
1145,1954-06-07,Thomasville,Delaware,29634,900,900,0,9/16/2020 18:20,10/17/2020 19:50
1146,1996-02-08,Thomasville,District of Columbia,29634,4450,4950,500,9/16/2020 19:51,6/21/2022 17:10
1147,1978-01-27,Thomasville,Florida,29634,1420,1420,0,9/16/2020 20:17,3/1/2022 20:46
1148,2001-03-21,Thomasville,Georgia,29634,1820,1820,0,9/16/2020 21:06,4/10/2022 23:17
1149,1999-07-23,Thomasville,Hawaii,29634,1700,1700,0,9/16/2020 21:11,5/3/2022 19:15
1150,1980-12-16,Thomasville,Idaho,29634,3220,3220,0,9/16/2020 21:16,5/2/2022 18:02
1151,1952-12-22,Thomasville,Illinois,29634,2130,2130,0,9/16/2020 21:34,1/22/2022 19:13
1152,1980-09-06,Thomasville,Indiana,29634,7225,7725,500,9/16/2020 21:36,4/19/2022 23:47
1153,1953-12-07,Thomasville,Iowa,29634,1240,1540,300,9/16/2020 22:02,11/27/2021 19:11
1154,1957-01-02,Thomasville,Kansas,29634,625,625,0,9/16/2020 23:15,1/10/2022 17:24
1155,1970-03-08,Thomasville,Kentucky,29634,400,400,0,9/16/2020 23:31,3/15/2022 19:00
1156,1973-06-06,Thomasville,Louisiana,29634,1740,1740,0,9/16/2020 23:48,6/30/2022 16:46
1157,1989-01-03,Thomasville,Maine,29634,400,400,0,9/16/2020 23:54,3/14/2022 11:20
1158,1952-11-23,Thomasville,Maryland,29634,1500,1500,0,9/17/2020 8:16,2/3/2022 22:39
1159,1995-01-26,Clemmons,North Carolina,27012,6225,8300,2075,9/17/2020 10:30,5/5/2022 21:45
1160,1954-06-27,Winston-Salem,North Carolina,27109,340,1990,1650,9/17/2020 10:32,12/4/2021 22:45
1161,1953-01-11,Thomasville,Massachusetts,29634,1820,1820,0,9/17/2020 10:33,1/1/2022 12:37
1162,1986-02-07,Thomasville,Michigan,29634,920,920,0,9/17/2020 10:47,2/12/2022 14:41
1163,1953-11-10,Thomasville,Minnesota,29634,1200,1200,0,9/17/2020 11:02,
1164,1970-03-28,Thomasville,Mississippi,29634,1400,1400,0,9/17/2020 11:17,4/18/2022 18:01
1165,1992-10-05,Thomasville,Missouri,29634,770,770,0,9/17/2020 11:49,4/18/2022 18:31
1166,1997-03-22,Thomasville,Montana,29634,950,950,0,9/17/2020 12:08,3/3/2022 8:46
1167,1988-04-03,Winston-Salem,North Carolina,27104,690,700,10,9/17/2020 12:34,10/8/2021 11:49
1168,1976-09-24,Thomasville,Nebraska,29634,940,940,0,9/17/2020 13:15,5/9/2021 23:58
1169,1983-08-08,Thomasville,Nevada,29634,450,450,0,9/17/2020 13:35,2/26/2022 18:55
1170,1999-05-05,Thomasville,New Hampshire,29634,650,650,0,9/17/2020 13:38,1/12/2022 18:22
1171,1979-11-03,Thomasville,New Jersey,29634,2140,2140,0,9/17/2020 13:42,6/29/2022 18:50
1172,1979-09-06,Thomasville,New Mexico,29634,1200,1200,0,9/17/2020 13:48,12/2/2021 15:46
1173,1989-11-02,Winston-Salem,North Carolina,27109,360,1420,1060,9/17/2020 14:24,11/30/2021 20:28
1174,1985-02-18,Thomasville,New York,29634,500,500,0,9/17/2020 15:34,2/12/2022 12:47
1175,1999-01-28,Thomasville,North Carolina,29634,950,950,0,9/17/2020 16:05,10/12/2020 17:21
1176,1985-05-25,Thomasville,North Dakota,29634,2360,2860,500,9/17/2020 16:20,4/19/2022 14:15
1177,2001-06-03,Thomasville,Ohio,29634,400,400,0,9/17/2020 16:36,9/10/2021 10:31
1178,1967-10-16,Thomasville,Oklahoma,29634,400,400,0,9/17/2020 16:37,
1179,2021-12-05,Bakersfield,California,93312,8510,14510,6000,9/17/2020 16:50,6/25/2022 0:42
1180,2001-06-04,Thomasville,Oregon,29634,4270,6020,1750,9/17/2020 20:57,4/10/2022 11:54
1181,2001-05-24,Thomasville,Pennsylvania,29634,6180,6180,0,9/17/2020 21:54,4/19/2022 0:44
1182,1976-12-21,Thomasville,Rhode Island,29634,930,930,0,9/17/2020 22:20,5/17/2022 18:36
1183,1996-05-08,Thomasville,South Carolina,29634,600,600,0,9/17/2020 23:31,10/20/2020 8:14
1184,1992-01-07,Thomasville,South Dakota,29634,760,760,0,9/18/2020 6:53,3/25/2022 17:54
1185,1952-02-28,Thomasville,Tennessee,29634,885,885,0,9/18/2020 15:58,3/2/2022 9:16
1186,1951-03-12,Thomasville,Texas,29634,2355,2355,0,9/18/2020 16:16,4/19/2022 9:21
1187,1986-05-04,Thomasville,Utah,29634,3860,3860,0,9/19/2020 0:35,3/15/2022 14:13
1188,1993-03-25,Thomasville,Vermont,29634,600,600,0,9/19/2020 11:01,
1189,1993-10-09,Thomasville,Virginia,29634,910,1910,1000,9/19/2020 15:35,4/9/2022 14:24
1190,1973-10-25,Thomasville,Washington,29634,1260,1260,0,9/19/2020 16:08,3/2/2022 12:32
1191,1983-12-28,Thomasville,West Virginia,29634,4245,4245,0,9/19/2020 16:40,3/8/2022 17:38
1192,1960-11-22,Lexington ,North Carolina,27295,6350,6500,150,9/19/2020 16:42,4/16/2022 9:37
1193,1993-12-22,Thomasville,Wisconsin,29634,900,900,0,9/19/2020 16:44,9/2/2021 19:06
1194,2004-12-20,Thomasville,Wyoming,29634,1260,1260,0,9/19/2020 18:13,2/21/2022 9:32
1195,1999-08-16,Thomasville,Alabama,29634,225,6225,6000,9/19/2020 20:06,6/4/2022 9:19
1196,1961-12-06,Thomasville,Alaska,29634,7895,7895,0,9/19/2020 20:11,6/30/2022 19:19
1197,1978-12-16,Thomasville,Arizona,29634,850,850,0,9/20/2020 15:38,2/19/2022 12:49
1198,1961-02-19,Thomasville,Arkansas,29634,1830,1830,0,9/20/2020 19:16,5/10/2022 18:24
1199,2002-06-25,Winston-Salem,North Carolina,80439,3575,4835,1260,9/20/2020 19:16,5/24/2022 19:26
1200,1970-11-10,Mt. Pleasant,South Carolina,29464,1030,1050,20,9/20/2020 19:16,3/16/2022 18:51
1201,1963-11-09,Thomasville,California,29634,1050,1050,0,9/20/2020 20:45,2/26/2022 19:42
1202,1967-03-19,Thomasville,Colorado,29634,950,950,0,9/22/2020 0:20,3/12/2022 10:44
1203,1964-08-02,Thomasville,Connecticut,29634,110,610,500,9/22/2020 0:22,4/22/2022 11:59
1204,2002-08-17,Thomasville,Delaware,29634,1640,1640,0,9/22/2020 10:49,4/29/2022 16:23
1205,1961-07-18,Thomasville,District of Columbia,29634,1260,1560,300,9/23/2020 10:53,4/16/2021 17:25
1206,1987-01-09,Thomasville,Florida,29634,4525,5025,500,9/23/2020 10:55,5/3/2022 17:49
1207,1952-12-04,Thomasville,Georgia,29634,1560,1560,0,9/23/2020 11:31,10/14/2020 17:31
1208,1990-06-06,Thomasville,Hawaii,29634,3060,3060,0,9/23/2020 17:10,3/15/2022 18:22
1209,2000-02-06,Thomasville,Idaho,29634,2010,2010,0,9/23/2020 20:39,4/15/2022 7:53
1210,2001-11-25,Thomasville,Illinois,29634,500,500,0,9/25/2020 16:17,12/4/2021 11:08
1211,2001-07-13,Thomasville,Indiana,29634,3030,3030,0,9/25/2020 16:30,5/5/2022 19:59
1212,2001-10-24,Winston-Salem,North Carolina,27106,1320,1320,0,9/25/2020 16:31,4/24/2021 20:18
1213,1971-12-08,Warren,New Jersey,7059,3070,3770,700,9/25/2020 16:33,6/19/2022 5:54
1214,1955-04-23,Winston-Salem,North Carolina,27109,3160,3420,260,9/25/2020 16:41,6/30/2022 17:53
1215,1967-12-05,Winston-Salem ,North Carolina,27101,1450,2250,800,9/25/2020 16:43,3/16/2022 19:44
1216,1952-08-12,Thomasville,Iowa,29634,925,925,0,9/25/2020 16:52,2/18/2022 9:00
1217,1987-03-12,Thomasville,Kansas,29634,2170,2170,0,9/25/2020 16:52,5/3/2022 21:38
1218,1997-08-19,Thomasville,Kentucky,29634,1470,1970,500,9/25/2020 16:53,4/8/2022 22:25
1219,2000-12-15,Thomasville,Louisiana,29634,1500,1500,0,9/25/2020 16:57,2/25/2022 11:43
1220,1977-03-21,Thomasville,Maine,29634,930,930,0,9/25/2020 17:01,5/10/2022 14:21
1221,1985-09-03,Thomasville,Maryland,29634,4805,4805,0,9/25/2020 17:27,3/23/2022 10:25
1222,1955-07-07,Thomasville,Massachusetts,29634,1620,1620,0,9/25/2020 17:31,2/23/2022 13:59
1223,1970-07-06,Thomasville,Michigan,29634,490,490,0,9/25/2020 18:12,5/26/2022 20:33
1224,1960-03-16,Thomasville,Minnesota,29634,1050,1050,0,9/25/2020 18:50,3/22/2022 13:45
1225,1988-06-06,Thomasville,Mississippi,29634,1530,1530,0,9/25/2020 19:06,3/15/2022 15:23
1226,1991-12-11,Thomasville,Missouri,29634,1010,1310,300,9/25/2020 19:08,3/26/2022 17:24
1227,1986-10-01,Thomasville,Montana,29634,980,1280,300,9/25/2020 19:08,5/6/2022 11:00
1228,1972-04-06,Thomasville,Nebraska,29634,610,610,0,9/25/2020 19:09,3/29/2022 16:06
1229,1979-05-07,Thomasville,Nevada,29634,2215,2215,0,9/25/2020 19:27,6/28/2022 13:30
1230,1999-03-01,Thomasville,New Hampshire,29634,3080,3080,0,9/25/2020 20:22,6/28/2022 13:26
1231,1966-07-02,Thomasville,New Jersey,29634,2355,2355,0,9/25/2020 20:34,5/11/2022 13:20
1232,1984-10-04,Thomasville,New Mexico,29634,400,400,0,9/25/2020 20:37,1/22/2022 13:06
1233,1961-02-15,Thomasville,New York,29634,3720,5220,1500,9/25/2020 20:38,6/29/2022 15:50
1234,1975-01-24,Thomasville,North Carolina,29634,2395,2695,300,9/25/2020 21:28,3/2/2022 20:56
1235,1998-09-18,Thomasville,North Dakota,29634,1660,2160,500,9/25/2020 22:23,2/2/2022 14:06
1236,1950-11-16,Thomasville,Ohio,29634,800,800,0,9/25/2020 22:35,3/8/2022 14:10
1237,1998-11-10,Thomasville,Oklahoma,29634,1420,2920,1500,9/25/2020 22:41,3/21/2022 16:40
1238,2001-10-02,Thomasville,Oregon,29634,9945,9945,0,9/25/2020 23:17,4/16/2022 15:41
1239,1956-03-25,Thomasville,Pennsylvania,29634,4100,4100,0,9/25/2020 23:34,2/23/2022 11:10
1240,1973-12-09,Thomasville,Rhode Island,29634,5460,5460,0,9/25/2020 23:47,5/3/2022 20:40
1241,2000-05-28,Thomasville,South Carolina,29634,2735,2735,0,9/26/2020 1:04,4/18/2022 18:01
1242,2000-10-24,Thomasville,South Dakota,29634,10730,18730,8000,9/26/2020 1:21,3/25/2022 19:52
1243,2002-05-14,Waukegan,Illinois,60085,52165,52165,0,9/26/2020 1:22,6/30/2022 11:38
1244,2002-07-11,Thomasville,Tennessee,29634,1505,1505,0,9/26/2020 1:39,4/30/2021 18:20
1245,1999-09-30,Thomasville,Texas,29634,6540,6540,0,9/26/2020 2:10,5/1/2022 16:27
1246,1976-12-21,Thomasville,Utah,29634,750,350,0,9/26/2020 11:09,3/2/2022 19:50
1247,1999-10-15,Thomasville,Vermont,29634,10790,23240,12750,9/26/2020 12:15,7/1/2022 0:44
1248,1980-05-11,Thomasville,Virginia,29634,300,1100,1000,9/26/2020 12:51,1/13/2022 17:55
1249,1998-06-19,Thomasville,Washington,29634,760,1560,1000,9/26/2020 12:52,4/8/2022 12:45
1250,1999-07-23,Thomasville,West Virginia,29634,1960,1760,0,9/26/2020 13:10,2/26/2022 19:15
1251,1974-01-21,Thomasville,Wisconsin,29634,3725,3725,0,9/26/2020 15:38,4/10/2022 9:27
1252,1983-01-18,Thomasville,Wyoming,29634,1735,1735,0,9/26/2020 15:41,4/18/2022 18:02
1253,2000-05-23,Thomasville,Alabama,29634,12535,12535,0,9/26/2020 15:42,6/30/2022 13:45
1254,1998-06-24,Thomasville,Alaska,29634,500,500,0,9/26/2020 16:51,3/4/2022 12:32
1255,2002-09-15,Thomasville,Arizona,29634,1050,1050,0,9/26/2020 17:06,11/13/2021 22:38
1256,1953-04-28,Thomasville,Arkansas,29634,2060,2060,0,9/26/2020 17:36,3/19/2022 11:48
1257,1960-12-12,Thomasville,California,29634,6410,7410,1000,9/26/2020 17:55,6/30/2022 22:37
1258,1959-12-12,Thomasville,Colorado,29634,400,400,0,9/26/2020 17:59,2/19/2021 14:55
1259,1950-02-02,winston salem,North Carolina,27106,1480,1500,20,9/26/2020 18:11,2/12/2022 14:59
1260,1966-09-22,Thomasville,Connecticut,29634,1225,1225,0,9/26/2020 18:36,6/17/2022 9:29
1261,1999-01-23,Thomasville,Delaware,29634,845,845,0,9/26/2020 18:41,5/8/2022 13:23
1262,1996-10-28,Thomasville,District of Columbia,29634,1325,2125,800,9/26/2020 18:44,1/22/2022 21:43
1263,1965-07-15,Thomasville,Florida,29634,1375,1375,0,9/26/2020 19:15,2/26/2022 14:44
1264,2000-02-15,Thomasville,Georgia,29634,2800,3800,1000,9/26/2020 19:33,4/18/2022 18:01
1265,1991-10-18,Thomasville,Hawaii,29634,3260,3260,0,9/26/2020 19:34,5/10/2022 23:01
1266,2002-05-04,Thomasville,Idaho,29634,1490,1490,0,9/26/2020 19:40,4/8/2022 23:07
1267,1987-05-18,Thomasville,Illinois,29634,8820,8820,0,9/26/2020 20:02,6/17/2022 17:34
1268,1956-05-07,Thomasville,Indiana,29634,950,950,0,9/26/2020 20:05,2/21/2022 16:07
1269,2005-07-26,Silver Spring ,Maryland,20901,555,1690,1135,9/26/2020 20:29,5/21/2022 19:13
1270,1972-03-11,Thomasville,Iowa,29634,1810,1810,0,9/26/2020 20:41,3/19/2022 16:04
1271,2001-11-30,Thomasville,Kansas,29634,3535,3535,0,9/26/2020 23:09,6/30/2022 22:02
1272,1956-04-06,Thomasville,Kentucky,29634,1660,1660,0,9/26/2020 23:10,4/26/2022 23:44
1273,2001-12-20,Thomasville,Louisiana,29634,5300,5300,0,9/26/2020 23:10,6/30/2022 21:15
1274,2003-02-05,Thomasville,Maine,29634,3685,3685,0,9/26/2020 23:12,2/28/2022 17:41
1275,2002-05-08,Thomasville,Maryland,29634,700,700,0,9/26/2020 23:13,1/20/2022 20:35
1276,1969-12-04,Thomasville,Massachusetts,29634,2500,2500,0,9/27/2020 12:16,2/12/2022 13:42
1277,2004-09-06,Thomasville,Michigan,29634,1705,1705,0,9/27/2020 12:21,2/12/2022 14:23
1278,2000-10-26,Charlotte,North Carolina,28210,610,1110,500,9/27/2020 12:24,3/29/2022 9:11
1279,2002-09-15,Thomasville,Minnesota,29634,1930,1930,0,9/27/2020 12:35,3/19/2022 15:23
1280,1973-04-18,Thomasville,Mississippi,29634,950,1950,1000,9/27/2020 13:42,5/2/2022 11:15
1281,1990-12-10,Thomasville,Missouri,29634,620,620,0,9/27/2020 13:42,5/31/2022 14:17
1282,1976-09-11,Thomasville,Montana,29634,960,960,0,9/27/2020 13:45,2/12/2022 12:03
1283,2005-07-15,Thomasville,Nebraska,29634,1645,1645,0,9/27/2020 14:13,3/11/2022 2:16
1284,1958-01-04,Thomasville,Nevada,29634,900,900,0,9/27/2020 14:28,
1285,1977-09-27,Thomasville,New Hampshire,29634,1220,1220,0,9/27/2020 15:40,4/15/2022 14:00
1286,1999-06-24,Thomasville,New Jersey,29634,815,815,0,9/27/2020 16:03,4/7/2022 19:18
1287,1999-05-04,Thomasville,New Mexico,29634,6895,6895,0,9/27/2020 17:41,6/19/2022 16:20
1288,2000-07-14,Thomasville,New York,29634,1990,1990,0,9/27/2020 17:46,10/21/2021 23:01
1289,1981-04-20,Winston-Salem,North Carolina,27101,10,810,800,9/27/2020 17:58,11/30/2020 18:02
1290,1989-06-14,Thomasville,North Carolina,29634,1065,1065,0,9/27/2020 18:32,3/16/2022 10:13
1291,1990-04-05,Thomasville,North Dakota,29634,3580,3580,0,9/27/2020 19:00,6/20/2022 20:13
1292,1980-09-06,Winston-Salem,North Carolina,27106,1965,2585,620,9/27/2020 20:12,4/18/2022 11:00
1293,2002-11-26,Thomasville,Ohio,29634,3210,3210,0,9/27/2020 20:28,4/8/2022 18:50
1294,1985-10-23,Thomasville,Oklahoma,29634,1350,1350,0,9/27/2020 20:48,
1295,2000-11-10,Thomasville,Oregon,29634,1800,1800,0,9/27/2020 20:55,11/20/2021 16:37
1296,1984-02-12,Thomasville,Pennsylvania,29634,450,1450,1000,9/27/2020 21:04,3/15/2022 17:41
1297,1969-05-13,Thomasville,Rhode Island,29634,580,1080,500,9/27/2020 21:27,5/4/2022 12:05
1298,2001-11-19,Thomasville,South Carolina,29634,2370,2370,0,9/27/2020 21:27,5/7/2022 19:11
1299,2003-06-16,Thomasville,South Dakota,29634,900,900,0,9/27/2020 21:28,
1300,1969-09-27,Pfafftown ,North Carolina,27040,1435,1460,25,9/27/2020 22:12,5/24/2022 18:57
1301,1982-04-09,Thomasville,Tennessee,29634,750,750,0,9/27/2020 22:13,4/26/2021 17:08
1302,1970-03-26,Thomasville,Texas,29634,585,585,0,9/27/2020 23:21,4/18/2022 10:56
1303,1999-10-09,Thomasville,Utah,29634,1160,1460,300,9/27/2020 23:39,10/14/2020 11:50
1304,2002-03-30,Marblehead,Massachusetts,1945,4255,4555,300,9/27/2020 23:40,5/19/2022 11:07
1305,1954-07-24,Thomasville,Vermont,29634,860,860,0,9/27/2020 23:52,4/16/2022 17:11
1306,1971-11-18,Thomasville,Virginia,29634,400,400,0,9/28/2020 1:03,3/19/2022 16:58
1307,1982-05-18,Thomasville,Washington,29634,2500,3000,500,9/28/2020 1:07,3/18/2022 16:16
1308,1955-11-01,Thomasville,West Virginia,29634,1570,2070,500,9/28/2020 7:43,5/3/2022 17:59
1309,2001-09-15,Thomasville,Wisconsin,29634,2895,2895,0,9/28/2020 8:11,3/24/2022 13:44
1310,1978-01-22,Thomasville,Wyoming,29634,1180,1180,0,9/28/2020 8:24,3/4/2022 15:27
1311,1978-08-10,Thomasville,Alabama,29634,1750,1750,0,9/28/2020 8:37,3/12/2022 13:46
1312,2004-07-19,Thomasville,Alaska,29634,4645,4645,0,9/28/2020 8:39,4/16/2022 17:11
1313,1990-08-17,Thomasville,Arizona,29634,1860,2160,300,9/28/2020 8:49,3/13/2022 22:33
1314,1972-10-16,Thomasville,Arkansas,29634,580,1080,500,9/28/2020 9:30,2/26/2022 13:28
1315,1963-06-04,Thomasville,California,29634,6780,6780,0,9/28/2020 9:33,6/30/2022 15:21
1316,2003-01-11,Winston-Salem ,North Carolina,27106,800,1300,500,9/28/2020 9:45,5/3/2021 21:38
1317,1970-10-15,Thomasville,Colorado,29634,1695,2095,400,9/28/2020 9:54,4/11/2022 7:07
1318,2001-04-08,Thomasville,Connecticut,29634,2075,2075,0,9/28/2020 9:55,11/13/2021 17:42
1319,1973-05-23,Thomasville,Delaware,29634,1400,1400,0,9/28/2020 10:03,3/22/2022 9:56
1320,1951-02-11,Thomasville,District of Columbia,29634,400,400,0,9/28/2020 10:03,8/26/2021 19:25
1321,1955-05-27,Thomasville,Florida,29634,760,760,0,9/28/2020 10:07,5/11/2021 9:53
1322,1951-06-20,Thomasville,Georgia,29634,1150,1150,0,9/28/2020 10:10,3/14/2022 12:48
1323,1983-07-01,Thomasville,Hawaii,29634,830,830,0,9/28/2020 10:11,5/1/2021 22:12
1324,1986-09-03,Thomasville,Idaho,29634,700,700,0,9/28/2020 10:13,1/10/2022 20:02
1325,1992-10-26,Thomasville,Illinois,29634,3470,3470,0,9/28/2020 10:15,5/3/2022 11:56
1326,1966-10-08,Thomasville,Indiana,29634,7685,7685,0,9/28/2020 10:16,4/2/2022 22:49
1327,1953-10-08,Thomasville,Iowa,29634,1400,1400,0,9/28/2020 10:18,3/25/2022 18:19
1328,1963-03-02,Thomasville,Kansas,29634,1260,1260,0,9/28/2020 10:20,5/26/2022 20:06
1329,1981-02-20,Thomasville,Kentucky,29634,410,410,0,9/28/2020 10:20,2/18/2022 17:57
1330,1970-09-11,Thomasville,Louisiana,29634,1950,1950,0,9/28/2020 10:25,6/30/2022 9:40
1331,1951-08-09,Thomasville,Maine,29634,2150,2150,0,9/28/2020 10:34,7/1/2022 0:10
1332,1966-05-14,Thomasville,Maryland,29634,2250,3350,1100,9/28/2020 10:37,6/30/2022 14:03
1333,1965-05-01,Thomasville,Massachusetts,29634,440,440,0,9/28/2020 10:38,9/10/2021 17:19
1334,1989-10-22,Thomasville,Michigan,29634,475,475,0,9/28/2020 10:43,2/19/2022 12:15
1335,1984-06-16,Thomasville,Minnesota,29634,1600,1600,0,9/28/2020 10:59,1/24/2022 17:56
1336,1989-07-07,Thomasville,Mississippi,29634,1100,1100,0,9/28/2020 11:10,3/4/2022 16:22
1337,1979-06-09,Thomasville,Missouri,29634,1000,1000,0,9/28/2020 11:14,
1338,1956-05-05,Thomasville,Montana,29634,1300,1300,0,9/28/2020 11:14,
1339,1968-04-19,Thomasville,Nebraska,29634,700,700,0,9/28/2020 11:17,
1340,1985-12-28,Thomasville,Nevada,29634,1650,1650,0,9/28/2020 11:28,3/23/2022 9:01
1341,1954-09-19,Thomasville,New Hampshire,29634,1410,1410,0,9/28/2020 11:29,2/18/2022 13:04
1342,1991-06-12,Thomasville,New Jersey,29634,1050,1050,0,9/28/2020 11:44,2/20/2022 15:42
1343,1955-06-19,Thomasville,New Mexico,29634,1575,1575,0,9/28/2020 11:46,
1344,1985-04-19,Thomasville,New York,29634,730,730,0,9/28/2020 11:46,8/27/2021 17:22
1345,1983-02-07,Thomasville,North Carolina,29634,2685,2685,0,9/28/2020 11:49,1/12/2022 18:27
1346,1973-06-20,Thomasville,North Dakota,29634,1410,1410,0,9/28/2020 11:49,1/12/2022 17:37
1347,1984-03-01,Thomasville,Ohio,29634,1360,1360,0,9/28/2020 11:50,4/10/2021 14:51
1348,1952-10-27,Thomasville,Oklahoma,29634,2710,2710,0,9/28/2020 11:53,4/15/2022 11:40
1349,1967-04-11,Thomasville,Oregon,29634,10860,10860,0,9/28/2020 11:53,4/14/2022 12:31
1350,1954-01-02,Thomasville,Pennsylvania,29634,3615,3615,0,9/28/2020 11:54,5/21/2022 22:08
1351,1975-11-12,Thomasville,Rhode Island,29634,7470,7470,0,9/28/2020 11:56,6/19/2022 16:46
1352,1998-12-24,Thomasville,South Carolina,29634,955,1255,300,9/28/2020 11:57,5/9/2021 11:22
1353,1960-08-07,Thomasville,South Dakota,29634,2010,2010,0,9/28/2020 11:58,4/18/2022 10:56
1354,1995-08-18,Thomasville,Tennessee,29634,710,710,0,9/28/2020 11:58,4/29/2021 19:00
1355,1958-04-06,Thomasville,Texas,29634,710,710,0,9/28/2020 12:01,3/11/2021 14:08
1356,2002-10-15,Thomasville,Utah,29634,700,1200,500,9/28/2020 12:02,3/28/2022 16:01
1357,1979-09-07,Thomasville,Vermont,29634,700,700,0,9/28/2020 12:03,
1358,1955-03-18,Thomasville,Virginia,29634,750,750,0,9/28/2020 12:09,3/11/2022 4:31
1359,1956-02-10,Thomasville,Washington,29634,1000,1000,0,9/28/2020 12:09,
1360,1982-05-14,Thomasville,West Virginia,29634,1505,1505,0,9/28/2020 12:14,4/13/2022 22:03
1361,2005-09-10,Thomasville,Wisconsin,29634,1740,1740,0,9/28/2020 12:20,4/24/2022 22:01
1362,2001-03-07,Thomasville,Wyoming,29634,800,800,0,9/28/2020 12:26,
1363,1973-01-02,Thomasville,Alabama,29634,1800,2300,500,9/28/2020 12:34,3/13/2022 23:20
1364,2001-03-09,Morganton,North Carolina,28655,4980,4980,0,9/28/2020 12:42,6/30/2022 1:59
1365,2001-04-06,Locust,North Carolina,28097,2700,3200,500,9/28/2020 12:51,5/26/2022 20:10
1366,1958-12-21,Winston-Salem,North Carolina,27101,9080,9930,850,9/28/2020 13:02,4/16/2022 10:35
1367,1998-06-08,Thomasville,Alaska,29634,1440,1440,0,9/28/2020 13:08,5/7/2021 20:05
1368,1972-01-25,Winston-Salem,North Carolina,27106,1015,2690,1675,9/28/2020 13:14,5/8/2022 14:08
1369,1960-06-20,Thomasville,Arizona,29634,2245,2245,0,9/28/2020 13:17,6/8/2022 19:38
1370,1985-10-23,Thomasville,Arkansas,29634,1680,3430,1750,9/28/2020 13:32,4/18/2022 10:58
1371,1969-04-21,Thomasville,California,29634,700,700,0,9/28/2020 13:37,
1372,1999-03-06,Thomasville,Colorado,29634,2075,2375,300,9/28/2020 13:38,5/24/2021 9:37
1373,1987-08-09,Thomasville,Connecticut,29634,8740,13240,4500,9/28/2020 13:42,5/11/2022 15:24
1374,1981-01-21,Thomasville,Delaware,29634,1200,1200,0,9/28/2020 13:47,2/5/2022 12:13
1375,1986-09-11,Thomasville,District of Columbia,29634,510,510,0,9/28/2020 13:50,4/18/2022 10:57
1376,1990-11-28,Thomasville,Florida,29634,70,1820,1750,9/28/2020 13:52,4/15/2022 20:18
1377,1964-09-20,Winston-Salem ,North Carolina,27106,2310,3010,700,9/28/2020 13:57,5/7/2022 15:55
1378,1985-06-10,Thomasville,Georgia,29634,200,500,300,9/28/2020 14:19,
1379,1954-09-17,Thomasville,Hawaii,29634,3210,3210,0,9/28/2020 14:20,4/19/2022 18:14
1380,1961-08-03,Thomasville,Idaho,29634,2760,3060,300,9/28/2020 14:42,6/9/2022 13:28
1381,1957-01-02,winston salem,North Carolina,27106,1510,3520,2010,9/28/2020 14:43,4/19/2022 18:25
1382,1962-04-19,Thomasville,Illinois,29634,2360,2360,0,9/28/2020 14:51,4/11/2022 11:21
1383,2000-01-15,Thomasville,Indiana,29634,2970,2970,0,9/28/2020 14:54,4/19/2022 18:18
1384,1981-12-19,Thomasville,Iowa,29634,1880,1880,0,9/28/2020 14:58,4/23/2022 16:00
1385,1978-05-20,Thomasville,Kansas,29634,1875,1875,0,9/28/2020 14:59,3/14/2022 10:51
1386,2005-05-06,Thomasville,Kentucky,29634,2250,2250,0,9/28/2020 15:00,2/26/2022 18:52
1387,2005-04-23,Thomasville,Louisiana,29634,2570,4320,1750,9/28/2020 15:00,4/19/2022 18:14
1388,1975-09-18,Thomasville,Maine,29634,1580,1580,0,9/28/2020 15:11,10/19/2020 21:05
1389,2002-01-24,Thomasville,Maryland,29634,1320,1820,500,9/28/2020 15:48,4/30/2022 18:40
1390,1981-04-09,Thomasville,Massachusetts,29634,400,400,0,9/28/2020 15:57,11/13/2021 16:07
1391,1978-05-03,Thomasville,Michigan,29634,1695,1695,0,9/28/2020 15:58,3/17/2022 10:53
1392,2002-01-13,Thomasville,Minnesota,29634,1410,1410,0,9/28/2020 16:00,1/12/2022 12:38
1393,1967-01-19,Thomasville,Mississippi,29634,1420,1420,0,9/28/2020 16:10,3/19/2022 12:17
1394,1957-08-23,Thomasville,Missouri,29634,1650,1650,0,9/28/2020 16:17,3/30/2022 16:03
1395,2002-01-10,Thomasville,Montana,29634,2180,2180,0,9/28/2020 16:23,1/23/2022 11:27
1396,2000-09-28,Thomasville,Nebraska,29634,1310,1310,0,9/28/2020 16:31,4/29/2022 18:07
1397,1985-01-09,Thomasville,Nevada,29634,300,300,0,9/28/2020 16:42,
1398,1968-05-18,Thomasville,New Hampshire,29634,430,2930,2500,9/28/2020 16:50,5/9/2021 23:09
1399,1954-06-13,Thomasville,New Jersey,29634,860,2860,2000,9/28/2020 16:56,4/27/2021 17:15
1400,2003-12-09,Thomasville,New Mexico,29634,660,1160,500,9/28/2020 16:59,3/31/2022 13:38
1401,1976-06-04,Thomasville,New York,29634,1750,1750,0,9/28/2020 17:24,3/1/2022 13:21
1402,2002-11-28,Thomasville,North Carolina,29634,1445,1445,0,9/28/2020 17:27,5/26/2022 20:09
1403,1964-09-21,Thomasville,North Dakota,29634,1360,1360,0,9/28/2020 17:29,4/17/2022 17:15
1404,1976-12-10,Thomasville,Ohio,29634,2130,2130,0,9/28/2020 17:30,5/11/2022 18:16
1405,1999-07-12,Thomasville,Oklahoma,29634,1675,1675,0,9/28/2020 17:38,3/6/2021 15:01
1406,1999-12-08,Mooresville,North Carolina,28115,2165,3755,1590,9/28/2020 17:40,3/30/2022 16:21
1407,1960-03-07,Thomasville,Oregon,29634,1630,1630,0,9/28/2020 17:41,4/16/2022 16:42
1408,1999-10-19,Thomasville,Pennsylvania,29634,4425,5925,1500,9/28/2020 17:42,5/18/2022 16:03
1409,1977-09-03,Thomasville,Rhode Island,29634,1500,1500,0,9/28/2020 17:44,2/16/2022 11:40
1410,2002-11-09,Thomasville,South Carolina,29634,1860,1860,0,9/28/2020 17:46,4/15/2022 18:58
1411,1969-10-23,Thomasville,South Dakota,29634,3165,3165,0,9/28/2020 17:49,6/3/2022 18:46
1412,1991-07-16,Thomasville,Tennessee,29634,400,400,0,9/28/2020 17:49,3/9/2022 1:18
1413,1966-09-25,Thomasville,Texas,29634,160,1260,1100,9/28/2020 17:49,5/12/2021 15:35
1414,1986-01-25,Thomasville,Utah,29634,2700,2700,0,9/28/2020 17:50,4/6/2022 17:45
1415,2000-12-23,Thomasville,Vermont,29634,1100,1100,0,9/28/2020 17:58,2/12/2022 15:45
1416,2021-10-04,Thomasville,Virginia,29634,1220,1220,0,9/28/2020 18:01,5/11/2022 17:17
1417,1989-07-19,Thomasville,Washington,29634,1130,1130,0,9/28/2020 18:03,4/29/2022 13:44
1418,2000-08-27,Thomasville,West Virginia,29634,820,820,0,9/28/2020 18:05,5/11/2022 13:24
1419,2003-08-16,Thomasville,Wisconsin,29634,2180,2180,0,9/28/2020 18:07,4/27/2022 15:54
1420,1964-11-04,Wellesley,Massachusetts,2481,1630,2730,1100,9/28/2020 18:08,6/4/2022 11:55
1421,2000-09-18,Thomasville,Wyoming,29634,710,1010,300,9/28/2020 18:10,4/15/2022 18:59
1422,1956-12-22,Thomasville,Alabama,29634,1700,1700,0,9/28/2020 18:11,3/25/2022 18:41
1423,1954-03-21,Thomasville,Alaska,29634,810,810,0,9/28/2020 18:12,1/22/2022 14:41
1424,1990-12-27,Thomasville,Arizona,29634,500,500,0,9/28/2020 18:13,11/27/2021 19:32
1425,1978-07-22,Thomasville,Arkansas,29634,830,830,0,9/28/2020 18:20,4/11/2022 14:00
1426,1981-09-26,Thomasville,California,29634,4935,4935,0,9/28/2020 18:21,4/29/2022 18:07
1427,1968-07-05,Thomasville,Colorado,29634,560,1060,500,9/28/2020 18:21,6/27/2022 10:16
1428,1999-01-08,Thomasville,Connecticut,29634,1860,1860,0,9/28/2020 18:22,5/11/2022 18:19
1429,2002-10-10,Thomasville,Delaware,29634,3020,3020,0,9/28/2020 18:25,4/8/2022 21:54
1430,1957-02-09,Thomasville,District of Columbia,29634,810,810,0,9/28/2020 18:31,3/24/2022 18:04
1431,2002-08-26,Thomasville,Florida,29634,1885,1885,0,9/28/2020 18:36,3/16/2022 8:27
1432,1954-06-13,Thomasville,Georgia,29634,2110,2110,0,9/28/2020 18:38,6/30/2022 0:42
1433,2002-04-20,Thomasville,Hawaii,29634,400,400,0,9/28/2020 18:55,2/26/2022 18:18
1434,2002-01-13,Thomasville,Idaho,29634,2330,2330,0,9/28/2020 19:01,5/3/2022 22:40
1435,1997-11-23,Thomasville,Illinois,29634,550,550,0,9/28/2020 19:15,3/1/2022 12:00
1436,1983-08-18,Thomasville,Indiana,29634,950,1450,500,9/28/2020 19:17,3/2/2022 20:51
1437,1955-01-16,Thomasville,Iowa,29634,625,625,0,9/28/2020 19:19,
1438,1960-03-22,Thomasville,Kansas,29634,1485,1485,0,9/28/2020 19:19,11/16/2021 16:43
1439,1966-02-01,Thomasville,Kentucky,29634,2035,2035,0,9/28/2020 19:23,1/27/2022 11:56
1440,1974-04-26,Thomasville,Louisiana,29634,410,710,300,9/28/2020 19:26,4/24/2021 11:12
1441,1994-01-12,Thomasville,Maine,29634,1060,1060,0,9/28/2020 19:28,4/12/2022 21:13
1442,1955-08-17,Thomasville,Maryland,29634,700,700,0,9/28/2020 19:32,10/12/2020 19:45
1443,1976-09-07,Thomasville,Massachusetts,29634,750,1750,1000,9/28/2020 19:37,1/22/2022 18:00
1444,2001-10-01,Thomasville,Michigan,29634,1235,1235,0,9/28/2020 19:47,2/23/2022 10:45
1445,1990-08-26,Thomasville,Minnesota,29634,4850,5050,200,9/28/2020 19:55,4/18/2022 21:07
1446,2003-02-28,Thomasville,Mississippi,29634,2470,2470,0,9/28/2020 19:56,6/7/2022 6:57
1447,1999-12-13,Thomasville,Missouri,29634,3110,3110,0,9/28/2020 20:16,5/3/2022 18:27
1448,1998-03-01,Thomasville,Montana,29634,1225,1225,0,9/28/2020 20:17,1/12/2022 18:15
1449,1980-09-16,Thomasville,Nebraska,29634,700,700,0,9/28/2020 20:22,10/20/2020 13:54
1450,1958-05-07,Thomasville,Nevada,29634,1900,1900,0,9/28/2020 20:28,5/4/2022 11:47
1451,1985-08-11,Thomasville,New Hampshire,29634,1085,1085,0,9/28/2020 20:33,11/30/2021 18:57
1452,1964-11-28,Thomasville,New Jersey,29634,775,775,0,9/28/2020 20:37,1/12/2022 18:34
1453,1988-11-04,Thomasville,New Mexico,29634,100,400,300,9/28/2020 20:38,2/27/2022 16:57
1454,2001-01-04,Thomasville,New York,29634,3595,3595,0,9/28/2020 20:39,5/7/2022 19:29
1455,1973-09-07,Thomasville,North Carolina,29634,1670,1670,0,9/28/2020 20:41,1/22/2022 19:20
1456,1993-05-03,Thomasville,North Dakota,29634,1955,1955,0,9/28/2020 20:41,6/29/2022 22:21
1457,1977-05-03,Thomasville,Ohio,29634,700,700,0,9/28/2020 20:47,
1458,1950-10-24,Thomasville,Oklahoma,29634,1100,1100,0,9/28/2020 20:50,
1459,1999-12-29,Thomasville,Oregon,29634,4635,4635,0,9/28/2020 20:51,3/16/2022 18:42
1460,1997-12-04,Thomasville,Pennsylvania,29634,13000,13200,200,9/28/2020 20:51,6/1/2022 14:31
1461,1990-10-25,Thomasville,Rhode Island,29634,560,560,0,9/28/2020 20:53,
1462,2004-05-13,Thomasville,South Carolina,29634,1210,1210,0,9/28/2020 20:54,5/2/2022 11:57
1463,1950-12-25,Thomasville,South Dakota,29634,700,700,0,9/28/2020 20:57,
1464,1998-06-24,Thomasville,Tennessee,29634,2360,2860,500,9/28/2020 20:57,6/9/2022 15:33
1465,1998-10-28,Thomasville,Texas,29634,1295,2095,800,9/28/2020 20:58,5/11/2021 9:34
1466,1989-12-04,Thomasville,Utah,29634,2090,2590,500,9/28/2020 20:59,6/30/2022 14:25
1467,1997-10-27,Thomasville,Vermont,29634,1110,1110,0,9/28/2020 21:02,5/11/2021 19:42
1468,2000-06-02,Thomasville,Virginia,29634,3970,3970,0,9/28/2020 21:03,5/21/2022 17:14
1469,1959-01-19,Thomasville,Washington,29634,420,420,0,9/28/2020 21:04,7/28/2021 9:40
1470,1997-02-11,Thomasville,West Virginia,29634,400,400,0,9/28/2020 21:05,
1471,2004-06-13,Thomasville,Wisconsin,29634,750,750,0,9/28/2020 21:06,1/22/2022 19:25
1472,1985-02-04,Thomasville,Wyoming,29634,860,1010,150,9/28/2020 21:09,6/3/2021 17:00
1473,1951-02-06,Thomasville,Alabama,29634,1500,1500,0,9/28/2020 21:21,1/12/2022 18:59
1474,2000-03-27,Thomasville,Alaska,29634,3620,3620,0,9/28/2020 21:21,5/11/2022 21:07
1475,1962-04-20,Thomasville,Arizona,29634,1000,1000,0,9/28/2020 21:22,2/7/2022 15:48
1476,1996-12-22,Thomasville,Arkansas,29634,1050,1050,0,9/28/2020 21:23,2/22/2022 10:12
1477,1974-03-15,Thomasville,California,29634,4705,4705,0,9/28/2020 21:26,6/30/2022 22:07
1478,1989-08-05,Thomasville,Colorado,29634,780,780,0,9/28/2020 21:26,6/21/2021 9:33
1479,1982-05-28,Thomasville,Connecticut,29634,2650,2650,0,9/28/2020 21:29,3/25/2022 18:13
1480,2021-06-02,Thomasville,Delaware,29634,4660,4660,0,9/28/2020 21:33,4/16/2022 13:45
1481,1959-07-19,Thomasville,District of Columbia,29634,700,700,0,9/28/2020 21:35,3/6/2022 1:53
1482,1987-04-03,Thomasville,Florida,29634,2450,2750,300,9/28/2020 21:40,6/30/2022 12:22
1483,1993-10-15,Thomasville,Georgia,29634,1100,1100,0,9/28/2020 21:41,3/25/2022 18:01
1484,2005-12-06,Thomasville,Hawaii,29634,600,2100,1500,9/28/2020 21:43,2/28/2022 17:45
1485,1998-08-13,Thomasville,Idaho,29634,1635,1635,0,9/28/2020 21:46,3/19/2022 16:04
1486,1963-06-17,Thomasville,Illinois,29634,6270,7270,1000,9/28/2020 21:51,4/12/2022 13:02
1487,1986-09-24,Winston-Salem ,North Carolina,27106,90,1090,1000,9/28/2020 21:55,11/24/2021 0:39
1488,1993-07-24,Thomasville,Indiana,29634,1555,1555,0,9/28/2020 21:57,12/29/2021 12:58
1489,1986-05-18,Thomasville,Iowa,29634,7275,7275,0,9/28/2020 21:58,5/3/2022 13:01
1490,1960-12-12,Thomasville,Kansas,29634,1100,1100,0,9/28/2020 22:02,2/23/2022 12:14
1491,1957-09-11,Winston-Salem,North Carolina,27106,1400,2200,800,9/28/2020 22:16,3/2/2022 23:09
1492,1998-08-15,Thomasville,Kentucky,29634,12600,33300,20700,9/28/2020 22:16,6/15/2022 23:37
1493,1963-12-18,Thomasville,Louisiana,29634,2420,2420,0,9/28/2020 22:17,5/9/2022 13:38
1494,1965-12-08,Thomasville,Maine,29634,450,450,0,9/28/2020 22:26,11/27/2021 17:56
1495,1963-05-15,Thomasville,Maryland,29634,910,910,0,9/28/2020 22:43,1/12/2022 17:10
1496,1964-02-08,Thomasville,Massachusetts,29634,3000,3000,0,9/28/2020 23:09,11/13/2021 23:21
1497,1961-03-09,Thomasville,Michigan,29634,2880,2880,0,9/28/2020 23:26,4/16/2022 19:15
1498,1953-04-10,Thomasville,Minnesota,29634,1025,1025,0,9/28/2020 23:27,3/28/2022 1:38
1499,1954-10-13,Thomasville,Mississippi,29634,1100,1100,0,9/28/2020 23:42,2/15/2022 21:04
1500,1979-07-22,Thomasville,Missouri,29634,450,450,0,9/29/2020 0:03,3/26/2022 12:45
1501,1964-11-11,Thomasville,Montana,29634,1265,1265,0,9/29/2020 1:07,3/2/2022 20:35
1502,1993-08-10,Thomasville,Nebraska,29634,1250,1250,0,9/29/2020 1:10,11/13/2021 19:42
1503,1956-10-20,Thomasville,Nevada,29634,1030,1580,550,9/29/2020 7:34,4/12/2022 17:53
1504,1964-06-07,Thomasville,New Hampshire,29634,610,1110,500,9/29/2020 8:39,2/4/2022 13:12
1505,1958-12-03,Thomasville,New Jersey,29634,2070,2070,0,9/29/2020 9:03,5/11/2022 18:59
1506,1998-08-20,Thomasville,New Mexico,29634,1250,1250,0,9/29/2020 9:04,3/19/2022 16:35
1507,1999-07-13,Thomasville,New York,29634,1000,1000,0,9/29/2020 9:13,3/5/2022 10:48
1508,1986-06-14,Thomasville,North Carolina,29634,995,1595,600,9/29/2020 9:19,5/10/2021 21:43
1509,2003-02-22,Thomasville,North Dakota,29634,8530,9530,1000,9/29/2020 10:23,5/9/2022 19:18
1510,2003-11-11,Thomasville,Ohio,29634,1140,1140,0,9/29/2020 10:33,2/27/2022 18:46
1511,1995-04-06,Thomasville,Oklahoma,29634,430,430,0,9/29/2020 10:48,4/22/2022 17:02
1512,1968-10-12,Thomasville,Oregon,29634,1105,1405,300,9/29/2020 11:03,4/15/2022 14:00
1513,1975-01-13,Thomasville,Pennsylvania,29634,1275,1275,0,9/29/2020 11:08,10/20/2020 20:28
1514,2001-06-25,Dallas,Texas,75205,2650,3650,1000,9/29/2020 11:16,6/30/2022 0:15
1515,1998-08-26,Thomasville,Rhode Island,29634,1610,1610,0,9/29/2020 11:30,4/16/2022 17:05
1516,2001-12-28,Thomasville,South Carolina,29634,4010,4010,0,9/29/2020 11:31,3/15/2022 9:04
1517,1996-03-22,Thomasville,South Dakota,29634,2900,3200,300,9/29/2020 11:31,3/29/2022 16:19
1518,1986-06-06,Thomasville,Tennessee,29634,700,700,0,9/29/2020 11:45,
1519,1963-02-17,Thomasville,Texas,29634,600,600,0,9/29/2020 11:52,
1520,1998-07-26,Thomasville,Utah,29634,450,450,0,9/29/2020 11:59,3/2/2022 20:39
1521,1957-11-12,Thomasville,Vermont,29634,960,960,0,9/29/2020 12:01,12/13/2021 0:23
1522,1992-05-03,Thomasville,Virginia,29634,1060,1060,0,9/29/2020 12:01,3/26/2022 20:39
1523,2002-08-22,Thomasville,Washington,29634,1260,1760,500,9/29/2020 12:02,5/22/2022 22:45
1524,2004-07-01,Thomasville,West Virginia,29634,4090,4090,0,9/29/2020 12:03,2/25/2022 15:22
1525,1987-05-28,Thomasville,Wisconsin,29634,3220,3220,0,9/29/2020 12:08,5/14/2022 18:28
1526,1967-11-02,Winston-Salem ,North Carolina,19073,320,760,440,9/29/2020 12:26,5/7/2021 11:57
1527,1992-03-05,Thomasville,Wyoming,29634,850,1150,300,9/29/2020 12:28,
1528,2003-05-23,Thomasville,Alabama,29634,410,710,300,9/29/2020 12:28,3/1/2021 16:11
1529,1989-11-22,Thomasville,Alaska,29634,0,950,950,9/29/2020 12:29,3/7/2021 13:30
1530,1982-01-17,Thomasville,Arizona,29634,700,700,0,9/29/2020 12:30,2/12/2022 14:48
1531,1954-06-03,Thomasville,Arkansas,29634,1350,1350,0,9/29/2020 12:31,3/25/2022 18:13
1532,1950-05-07,Thomasville,California,29634,2090,2590,500,9/29/2020 12:32,1/26/2022 8:35
1533,1953-11-09,Thomasville,Colorado,29634,1460,1460,0,9/29/2020 12:39,6/2/2022 15:13
1534,1971-02-11,Thomasville,Connecticut,29634,1220,1720,500,9/29/2020 12:41,5/11/2022 13:01
1535,1996-04-20,Thomasville,Delaware,29634,1125,1625,500,9/29/2020 12:42,8/27/2021 19:00
1536,1998-08-27,Thomasville,District of Columbia,29634,580,880,300,9/29/2020 12:44,2/7/2022 12:43
1537,1987-09-25,Thomasville,Florida,29634,2670,4670,2000,9/29/2020 12:55,4/5/2022 17:33
1538,1972-02-12,Thomasville,Georgia,29634,1300,1300,0,9/29/2020 13:08,
1539,1990-05-06,The Woodlands ,Texas,77375,790,1000,210,9/29/2020 13:08,1/22/2022 21:49
1540,2002-03-04,Thomasville,Hawaii,29634,11010,11010,0,9/29/2020 13:16,4/11/2022 14:00
1541,1956-09-19,Thomasville,Idaho,29634,1660,1660,0,9/29/2020 13:18,3/1/2022 22:35
1542,1998-01-24,Winston-Salem,North Carolina,27106,2050,2800,750,9/29/2020 13:27,3/19/2022 16:07
1543,1999-05-20,Winston-Salem,North Carolina,27106,1390,1400,10,9/29/2020 13:29,10/21/2020 11:11
1544,1971-07-27,Thomasville,Illinois,29634,595,1095,500,9/29/2020 13:47,9/14/2021 11:45
1545,1966-11-03,Thomasville,Indiana,29634,475,775,300,9/29/2020 13:53,5/8/2021 20:16
1546,1954-07-14,Thomasville,Iowa,29634,145,745,600,9/29/2020 13:53,4/30/2021 15:39
1547,1953-09-07,Thomasville,Kansas,29634,400,700,300,9/29/2020 13:54,
1548,1993-07-11,Thomasville,Kentucky,29634,3560,3860,300,9/29/2020 14:01,5/11/2022 20:06
1549,1959-11-06,Thomasville,Louisiana,29634,870,870,0,9/29/2020 14:08,6/27/2022 20:10
1550,1957-06-24,Thomasville,Maine,29634,1800,2300,500,9/29/2020 14:13,2/26/2022 18:40
1551,1986-04-02,Thomasville,Maryland,29634,900,900,0,9/29/2020 14:38,9/3/2021 10:00
1552,1953-04-04,Thomasville,Massachusetts,29634,1715,1715,0,9/29/2020 14:47,3/23/2022 21:00
1553,1998-08-04,Thomasville,Michigan,29634,960,960,0,9/29/2020 14:55,5/27/2021 23:46
1554,2001-06-29,Thomasville,Minnesota,29634,5065,5865,800,9/29/2020 15:13,6/30/2022 20:14
1555,1992-03-05,Thomasville,Mississippi,29634,2110,2410,300,9/29/2020 15:50,5/26/2022 20:06
1556,1965-05-15,Thomasville,Missouri,29634,1815,2115,300,9/29/2020 15:55,9/14/2021 7:22
1557,1993-07-01,Thomasville,Montana,29634,410,410,0,9/29/2020 16:03,4/29/2021 20:48
1558,1991-12-06,Thomasville,Nebraska,29634,140,450,310,9/29/2020 16:21,3/17/2022 9:52
1559,1961-11-26,Thomasville,Nevada,29634,500,500,0,9/29/2020 16:30,1/22/2022 17:15
1560,1980-11-27,Thomasville,New Hampshire,29634,410,410,0,9/29/2020 16:30,4/15/2021 13:31
1561,1969-08-24,Thomasville,New Jersey,29634,1000,1000,0,9/29/2020 16:31,1/22/2022 18:55
1562,1969-01-28,Thomasville,New Mexico,29634,600,600,0,9/29/2020 16:34,2/26/2022 20:22
1563,1981-03-16,Thomasville,New York,29634,1200,1200,0,9/29/2020 16:34,3/8/2022 14:15
1564,1965-02-24,Thomasville,North Carolina,29634,450,450,0,9/29/2020 16:35,1/22/2022 19:17
1565,1968-10-04,Thomasville,North Dakota,29634,1010,1010,0,9/29/2020 16:52,6/10/2022 19:29
1566,1996-03-21,Thomasville,Ohio,29634,400,400,0,9/29/2020 17:09,1/28/2022 12:31
1567,1976-10-04,Thomasville,Oklahoma,29634,455,5255,4800,9/29/2020 17:12,5/8/2022 13:12
1568,1998-07-17,Thomasville,Oregon,29634,2080,2080,0,9/29/2020 17:32,5/19/2021 13:35
1569,1988-06-25,Thomasville,Pennsylvania,29634,870,870,0,9/29/2020 17:32,6/30/2022 8:51
1570,2004-07-20,Thomasville,Rhode Island,29634,435,435,0,9/29/2020 18:14,4/8/2022 13:45
1571,2001-08-23,Thomasville,South Carolina,29634,5775,6775,1000,9/29/2020 18:14,5/15/2022 21:55
1572,1991-01-25,Thomasville,South Dakota,29634,1170,1170,0,9/29/2020 18:20,6/27/2022 16:46
1573,1986-12-24,Thomasville,Tennessee,29634,2470,2470,0,9/29/2020 18:39,5/3/2022 20:43
1574,1969-08-01,Thomasville,Texas,29634,1350,1350,0,9/29/2020 18:43,2/19/2022 14:04
1575,2000-01-06,Thomasville,Utah,29634,3580,7880,4300,9/29/2020 18:48,3/2/2022 23:02
1576,1951-01-07,Thomasville,Vermont,29634,1150,1150,0,9/29/2020 18:51,1/22/2022 20:00
1577,1981-10-03,Thomasville,Virginia,29634,400,400,0,9/29/2020 18:54,1/17/2022 17:18
1578,1977-06-21,Thomasville,Washington,29634,7150,8250,1100,9/29/2020 18:59,6/22/2022 21:44
1579,1953-06-09,Thomasville,West Virginia,29634,950,950,0,9/29/2020 18:59,4/13/2022 19:29
1580,2001-06-03,Thomasville,Wisconsin,29634,3845,3845,0,9/29/2020 19:01,6/23/2022 11:22
1581,1989-03-06,Thomasville,Wyoming,29634,500,500,0,9/29/2020 19:04,1/12/2022 8:48
1582,1965-07-27,Thomasville,Alabama,29634,600,600,0,9/29/2020 19:08,1/22/2022 14:02
1583,2002-07-15,Thomasville,Alaska,29634,510,510,0,9/29/2020 19:11,2/26/2022 18:21
1584,1976-10-07,Thomasville,Arizona,29634,1195,1195,0,9/29/2020 19:18,4/8/2022 18:07
1585,1974-08-11,Wyomissing ,Pennsylvania,19610,1220,1255,35,9/29/2020 19:19,11/27/2021 16:42
1586,2001-04-23,Thomasville,Arkansas,29634,1750,1750,0,9/29/2020 19:25,3/17/2022 15:18
1587,1978-11-17,Thomasville,California,29634,760,760,0,9/29/2020 19:30,2/20/2022 20:24
1588,1996-07-20,Thomasville,Colorado,29634,550,550,0,9/29/2020 19:33,3/24/2022 18:03
1589,1955-02-06,Thomasville,Connecticut,29634,1730,1730,0,9/29/2020 19:48,5/12/2022 13:09
1590,2002-01-17,Thomasville,Delaware,29634,925,925,0,9/29/2020 19:48,1/22/2022 19:35
1591,1970-05-23,Thomasville,District of Columbia,29634,400,400,0,9/29/2020 19:55,
1592,1963-06-19,Thomasville,Florida,29634,400,400,0,9/29/2020 19:57,1/12/2022 14:29
1593,1971-03-12,Thomasville,Georgia,29634,400,400,0,9/29/2020 20:02,10/30/2021 15:31
1594,1976-08-02,Thomasville,Hawaii,29634,595,895,300,9/29/2020 20:08,5/2/2021 19:02
1595,2021-08-14,Thomasville,Idaho,29634,2795,2795,0,9/29/2020 20:10,6/21/2022 22:26
1596,2000-10-23,Thomasville,Illinois,29634,3170,3170,0,9/29/2020 20:12,11/16/2021 9:57
1597,1978-02-12,Thomasville,Indiana,29634,730,730,0,9/29/2020 20:14,6/20/2021 16:58
1598,2000-05-01,Thomasville,Iowa,29634,700,700,0,9/29/2020 20:14,
1599,1988-03-21,Thomasville,Kansas,29634,3140,3140,0,9/29/2020 20:28,4/8/2022 17:16
1600,1985-02-14,Thomasville,Kentucky,29634,850,850,0,9/29/2020 20:28,
1601,1987-05-24,Thomasville,Louisiana,29634,3020,3020,0,9/29/2020 20:44,4/10/2022 12:54
1602,2000-02-24,Thomasville,Maine,29634,3040,3040,0,9/29/2020 20:45,4/11/2022 14:48
1603,1988-07-03,Thomasville,Maryland,29634,910,1910,1000,9/29/2020 20:50,1/22/2022 19:59
1604,1969-11-17,Thomasville,Massachusetts,29634,2100,2100,0,9/29/2020 20:51,3/2/2022 21:47
1605,1967-01-28,Thomasville,Michigan,29634,1210,1210,0,9/29/2020 21:08,2/18/2022 10:59
1606,1959-09-06,Thomasville,Minnesota,29634,1420,1420,0,9/29/2020 21:09,6/19/2022 17:33
1607,1988-10-12,Thomasville,Mississippi,29634,2110,2110,0,9/29/2020 21:24,3/19/2022 15:50
1608,1993-06-05,Thomasville,Missouri,29634,860,860,0,9/29/2020 21:36,5/10/2021 17:06
1609,1987-06-11,Thomasville,Montana,29634,700,700,0,9/29/2020 21:41,
1610,2001-09-25,Thomasville,Nebraska,29634,2365,2365,0,9/29/2020 21:49,6/19/2022 20:59
1611,1951-05-07,Winston-Salem,North Carolina,27109,23765,50165,26400,9/29/2020 21:53,6/23/2022 13:54
1612,1990-04-01,Thomasville,Nevada,29634,1225,1225,0,9/29/2020 21:55,10/12/2020 21:08
1613,1999-05-01,Thomasville,New Hampshire,29634,735,735,0,9/29/2020 22:03,11/27/2021 19:00
1614,1955-05-26,Thomasville,New Jersey,29634,60,560,500,9/29/2020 22:04,1/31/2022 12:08
1615,1987-10-26,Thomasville,New Mexico,29634,700,700,0,9/29/2020 22:19,
1616,1992-09-15,Winston-Salem,North Carolina,27109,2735,3660,925,9/29/2020 22:31,5/19/2022 15:26
1617,2000-03-13,Thomasville,New York,29634,710,710,0,9/29/2020 22:33,4/11/2021 11:53
1618,1969-06-11,Thomasville,North Carolina,29634,1500,1500,0,9/29/2020 22:42,3/16/2022 14:02
1619,1957-11-14,Thomasville,North Dakota,29634,465,465,0,9/29/2020 22:49,3/2/2022 19:42
1620,1997-01-14,Thomasville,Ohio,29634,1040,2040,1000,9/29/2020 22:54,11/30/2021 18:51
1621,1981-08-14,Thomasville,Oklahoma,29634,610,610,0,9/29/2020 23:05,4/8/2022 9:00
1622,1999-09-19,Thomasville,Oregon,29634,700,700,0,9/29/2020 23:08,
1623,1989-10-18,Thomasville,Pennsylvania,29634,700,700,0,9/29/2020 23:08,10/21/2020 11:39
1624,1997-08-09,Thomasville,Rhode Island,29634,1220,1220,0,9/29/2020 23:11,3/19/2022 16:09
1625,1976-08-04,Thomasville,South Carolina,29634,860,1360,500,9/29/2020 23:17,4/15/2022 19:19
1626,1960-12-09,Thomasville,South Dakota,29634,1240,1240,0,9/29/2020 23:21,5/8/2022 9:22
1627,1956-03-13,Thomasville,Tennessee,29634,3400,3400,0,9/29/2020 23:26,3/29/2022 14:44
1628,1964-10-18,Thomasville,Texas,29634,150,650,500,9/29/2020 23:33,12/5/2021 17:18
1629,1987-11-27,Thomasville,Utah,29634,175,475,300,9/29/2020 23:34,11/13/2021 22:06
1630,1985-05-26,Thomasville,Vermont,29634,1420,1420,0,9/29/2020 23:37,5/6/2022 11:53
1631,1973-06-19,Thomasville,Virginia,29634,820,2820,2000,9/29/2020 23:38,4/15/2022 20:19
1632,1977-10-08,Thomasville,Washington,29634,700,700,0,9/29/2020 23:56,10/13/2020 22:06
1633,1994-12-24,Thomasville,West Virginia,29634,1010,1010,0,9/30/2020 1:27,3/7/2022 16:21
1634,1986-10-26,Big Flats,New York,14814,960,1960,1000,9/30/2020 1:38,3/14/2022 17:38
1635,2000-10-03,Sharon,Massachusetts,2067,6825,7145,320,9/30/2020 2:55,4/22/2022 13:46
1636,1976-03-11,WHIPPANY,New Jersey,7981,4060,4360,300,9/30/2020 7:21,6/30/2022 2:19
1637,1994-04-10,Thomasville,Wisconsin,29634,150,450,300,9/30/2020 7:42,1/22/2022 10:02
1638,1994-11-10,Thomasville,Wyoming,29634,700,700,0,9/30/2020 8:54,
1639,2003-02-07,Thomasville,Alabama,29634,1160,1160,0,9/30/2020 9:50,4/8/2022 12:44
1640,1979-05-15,Thomasville,Alaska,29634,5200,5200,0,9/30/2020 9:57,4/19/2022 20:50
1641,1985-09-05,Thomasville,Arizona,29634,435,935,500,9/30/2020 10:04,2/26/2022 13:51
1642,1951-02-23,Thomasville,Arkansas,29634,420,420,0,9/30/2020 10:17,4/16/2022 15:03
1643,1989-11-01,Thomasville,California,29634,2450,2450,0,9/30/2020 10:28,3/26/2022 16:11
1644,2000-05-09,Thomasville,Colorado,29634,920,920,0,9/30/2020 10:32,4/8/2022 22:28
1645,1956-01-23,Thomasville,Connecticut,29634,500,500,0,9/30/2020 10:40,1/22/2022 15:31
1646,1972-08-12,Thomasville,Delaware,29634,420,720,300,9/30/2020 10:47,5/9/2021 13:02
1647,2000-01-02,Thomasville,District of Columbia,29634,1180,1180,0,9/30/2020 10:49,4/16/2022 17:30
1648,1993-04-22,Thomasville,Florida,29634,540,540,0,9/30/2020 10:52,4/19/2022 18:31
1649,1979-07-05,Thomasville,Georgia,29634,700,700,0,9/30/2020 11:02,5/25/2021 22:05
1650,2002-02-10,Thomasville,Hawaii,29634,5400,5400,0,9/30/2020 11:16,5/10/2022 18:00
1651,2001-04-23,Thomasville,Idaho,29634,500,500,0,9/30/2020 11:53,3/2/2022 21:04
1652,2002-09-04,Thomasville,Illinois,29634,450,450,0,9/30/2020 11:56,11/27/2021 21:31
1653,1974-09-13,Thomasville,Indiana,29634,750,750,0,9/30/2020 12:53,1/30/2021 14:27
1654,1969-04-10,Thomasville,Iowa,29634,700,700,0,9/30/2020 13:05,
1655,1985-01-06,Thomasville,Kansas,29634,270,570,300,9/30/2020 13:19,4/9/2022 8:57
1656,1961-01-11,Thomasville,Kentucky,29634,1190,1190,0,9/30/2020 13:34,5/8/2022 18:19
1657,2001-11-16,Thomasville,Louisiana,29634,260,560,300,9/30/2020 14:10,2/26/2022 12:58
1658,1998-03-05,Thomasville,Maine,29634,500,500,0,9/30/2020 14:32,3/23/2022 14:05
1659,1974-10-24,Thomasville,Maryland,29634,920,920,0,9/30/2020 15:14,3/2/2022 19:45
1660,2001-11-11,Thomasville,Massachusetts,29634,100,400,300,9/30/2020 15:37,3/2/2021 13:17
1661,1985-04-27,Thomasville,Michigan,29634,2240,2240,0,9/30/2020 16:10,11/29/2021 19:20
1662,1970-02-28,Thomasville,Minnesota,29634,1010,1010,0,9/30/2020 16:11,1/28/2022 14:35
1663,1990-03-23,Thomasville,Mississippi,29634,2180,2180,0,9/30/2020 16:41,6/28/2022 18:47
1664,1965-08-03,Thomasville,Missouri,29634,750,750,0,9/30/2020 17:26,10/26/2020 16:26
1665,2002-02-11,Thomasville,Montana,29634,2490,2490,0,9/30/2020 17:35,3/2/2022 22:44
1666,1998-08-12,Thomasville,Nebraska,29634,5845,5845,0,9/30/2020 18:03,4/1/2022 14:30
1667,1987-09-07,Thomasville,Nevada,29634,2980,3280,300,9/30/2020 18:16,6/29/2022 17:08
1668,2000-10-10,Thomasville,New Hampshire,29634,3820,3820,0,9/30/2020 18:51,5/11/2022 20:06
1669,1995-01-16,Thomasville,New Jersey,29634,500,500,0,9/30/2020 19:09,1/22/2022 19:25
1670,1950-05-26,Thomasville,New Mexico,29634,550,550,0,9/30/2020 20:14,3/25/2022 14:41
1671,2000-10-20,Thomasville,New York,29634,11735,12035,300,9/30/2020 20:35,7/1/2022 1:20
1672,1984-03-28,Thomasville,North Carolina,29634,400,700,300,9/30/2020 20:41,
1673,1993-05-24,Thomasville,North Dakota,29634,1135,1135,0,9/30/2020 21:56,3/28/2022 16:14
1674,1968-07-17,Thomasville,Ohio,29634,610,1110,500,9/30/2020 22:29,5/18/2022 18:26
1675,2001-04-16,Thomasville,Oklahoma,29634,2310,2310,0,9/30/2020 23:07,2/4/2022 19:25
1676,1993-10-25,Thomasville,Oregon,29634,1800,1800,0,9/30/2020 23:15,3/15/2022 7:14
1677,1972-01-27,Thomasville,Pennsylvania,29634,1610,1610,0,9/30/2020 23:37,4/8/2022 19:38
1678,1973-09-27,Thomasville,Rhode Island,29634,1530,2030,500,9/30/2020 23:51,5/11/2022 18:20
1679,1960-09-27,Thomasville,South Carolina,29634,2540,2540,0,10/1/2020 0:06,4/7/2022 16:31
1680,2001-09-27,Thomasville,South Dakota,29634,1460,1960,500,10/1/2020 0:10,3/1/2022 19:50
1681,1991-09-25,Thomasville,Tennessee,29634,3740,3740,0,10/1/2020 8:30,4/1/2022 18:59
1682,1950-04-14,Thomasville,Texas,29634,225,525,300,10/1/2020 10:02,2/5/2022 20:07
1683,1996-11-08,Thomasville,Utah,29634,410,410,0,10/1/2020 11:01,3/19/2022 18:19
1684,1993-04-13,Thomasville,Vermont,29634,545,545,0,10/1/2020 12:07,4/9/2022 10:15
1685,1972-11-17,Thomasville,Virginia,29634,450,450,0,10/1/2020 12:25,3/24/2022 8:36
1686,1964-01-04,Thomasville,Washington,29634,1530,1530,0,10/1/2020 12:44,5/3/2021 21:25
1687,1986-08-09,Thomasville,West Virginia,29634,460,760,300,10/1/2020 13:12,4/16/2022 16:55
1688,2020-04-15,Thomasville,Wisconsin,29634,1300,1300,0,10/1/2020 14:40,3/25/2022 17:54
1689,1955-02-27,Thomasville,Wyoming,29634,410,410,0,10/1/2020 14:48,5/11/2022 17:53
1690,1959-02-25,Thomasville,Alabama,29634,2870,11870,9000,10/1/2020 15:01,6/29/2022 14:21
1691,1973-11-06,Thomasville,Alaska,29634,600,600,0,10/1/2020 17:52,10/14/2020 11:32
1692,1983-05-04,Thomasville,Arizona,29634,3990,4490,500,10/1/2020 18:12,4/21/2022 13:37
1693,2002-05-31,Larchmont,New York,10538,1880,1900,20,10/1/2020 18:18,6/30/2022 20:24
1694,1993-07-06,Thomasville,Arkansas,29634,100,400,300,10/1/2020 18:34,3/2/2022 9:00
1695,1951-09-16,Thomasville,California,29634,1550,1550,0,10/1/2020 18:39,3/1/2022 19:59
1696,1974-12-05,Thomasville,Colorado,29634,2850,2850,0,10/1/2020 18:42,3/24/2022 0:31
1697,1984-07-03,Thomasville,Connecticut,29634,750,750,0,10/1/2020 19:29,
1698,1983-02-28,Thomasville,Delaware,29634,500,500,0,10/1/2020 19:53,11/30/2021 20:14
1699,2005-04-09,Thomasville,District of Columbia,29634,450,750,300,10/1/2020 20:45,1/31/2022 7:51
1700,1972-01-13,Thomasville,Florida,29634,670,970,300,10/1/2020 21:24,5/20/2022 19:09
1701,1957-04-15,Thomasville,Georgia,29634,1220,1520,300,10/1/2020 21:52,6/17/2022 11:28
1702,1991-02-22,Thomasville,Hawaii,29634,1010,1010,0,10/1/2020 22:16,5/1/2022 10:45
1703,1979-09-10,Thomasville,Idaho,29634,680,1180,500,10/1/2020 22:45,3/5/2022 14:30
1704,2001-09-15,Thomasville,Illinois,29634,5375,5375,0,10/1/2020 23:45,3/14/2022 8:27
1705,1983-08-12,Thomasville,Indiana,29634,700,700,0,10/2/2020 8:07,
1706,2003-11-21,Thomasville,Iowa,29634,1635,1635,0,10/2/2020 10:07,3/2/2022 20:42
1707,1961-06-24,Thomasville,Kansas,29634,450,450,0,10/2/2020 10:48,11/27/2021 19:04
1708,2021-03-29,Thomasville,Kentucky,29634,2200,2200,0,10/2/2020 11:30,5/24/2022 17:55
1709,1972-05-22,Thomasville,Louisiana,29634,0,500,500,10/2/2020 12:00,2/28/2022 17:06
1710,1989-09-04,Thomasville,Maine,29634,705,1605,900,10/2/2020 12:27,5/19/2021 20:06
1711,1997-01-22,Thomasville,Maryland,29634,1080,1080,0,10/2/2020 12:31,6/7/2022 12:59
1712,1969-12-08,Thomasville,Massachusetts,29634,10,725,715,10/2/2020 12:32,4/26/2021 17:43
1713,1987-04-19,Thomasville,Michigan,29634,890,890,0,10/2/2020 13:45,5/11/2022 18:49
1714,1967-05-06,Thomasville,Minnesota,29634,1200,1200,0,10/2/2020 13:49,3/24/2022 18:01
1715,2001-06-24,Thomasville,Mississippi,29634,1660,1660,0,10/2/2020 14:22,11/30/2021 22:05
1716,1978-07-19,Thomasville,Missouri,29634,6290,6590,300,10/2/2020 14:30,12/1/2021 14:32
1717,2001-05-27,Thomasville,Montana,29634,950,950,0,10/2/2020 14:39,1/10/2022 19:40
1718,1968-04-12,Thomasville,Nebraska,29634,510,510,0,10/2/2020 16:05,11/30/2021 18:52
1719,2005-05-13,Thomasville,Nevada,29634,400,400,0,10/2/2020 16:14,10/14/2020 12:08
1720,1965-11-01,Thomasville,New Hampshire,29634,2045,2345,300,10/2/2020 17:06,6/30/2022 20:46
1721,2002-02-08,Thomasville,New Jersey,29634,8170,8170,0,10/2/2020 17:16,4/19/2022 12:48
1722,1980-04-13,Winston-Salem,North Carolina,27109,2460,2460,0,10/2/2020 17:55,7/1/2022 0:12
1723,1975-01-20,Thomasville,New Mexico,29634,1820,1820,0,10/2/2020 17:58,5/8/2021 13:16
1724,1994-05-18,Thomasville,New York,29634,1650,1650,0,10/2/2020 18:12,11/28/2021 21:32
1725,2001-10-17,Lmao,District of Columbia,69694,2380,2380,0,10/2/2020 18:19,12/11/2021 19:43
1726,2001-11-01,Thomasville,North Carolina,29634,3500,3500,0,10/2/2020 18:50,3/7/2022 18:00
1727,2002-01-12,Thomasville,North Dakota,29634,1290,1790,500,10/2/2020 19:27,5/3/2022 18:16
1728,1983-04-22,Thomasville,Ohio,29634,5385,5385,0,10/2/2020 19:30,6/14/2022 20:07
1729,1959-11-24,Thomasville,Oklahoma,29634,6295,6295,0,10/2/2020 19:31,5/6/2022 18:33
1730,1981-02-20,Thomasville,Oregon,29634,2535,2535,0,10/2/2020 19:50,4/19/2022 17:44
1731,2000-12-27,Thomasville,Pennsylvania,29634,1550,1850,300,10/2/2020 19:58,3/16/2022 16:54
1732,1961-09-06,Thomasville,Rhode Island,29634,1185,1185,0,10/2/2020 19:59,2/22/2022 9:56
1733,1992-12-27,Thomasville,South Carolina,29634,3765,3765,0,10/2/2020 20:25,6/27/2022 13:40
1734,1957-09-28,Thomasville,South Dakota,29634,400,700,300,10/2/2020 20:28,3/7/2021 16:27
1735,2004-04-25,Thomasville,Tennessee,29634,700,700,0,10/2/2020 20:36,
1736,1963-09-03,Thomasville,Texas,29634,400,400,0,10/2/2020 20:40,3/26/2022 19:37
1737,2000-01-24,Winston-Salem ,North Carolina,27109,6930,7230,300,10/2/2020 21:18,4/19/2022 12:56
1738,1980-08-11,Thomasville,Utah,29634,735,735,0,10/2/2020 21:30,4/13/2022 19:47
1739,1956-03-06,Thomasville,Vermont,29634,1345,1345,0,10/2/2020 21:34,4/30/2022 8:58
1740,2001-05-05,Indian Trail,North Carolina,28079,14300,14400,100,10/2/2020 21:45,6/30/2022 8:34
1741,1991-09-27,Thomasville,Virginia,29634,500,500,0,10/2/2020 23:16,1/22/2022 19:12
1742,1992-01-16,Thomasville,Washington,29634,910,910,0,10/3/2020 10:47,4/8/2022 9:02
1743,1952-09-03,Thomasville,West Virginia,29634,790,790,0,10/3/2020 11:37,5/9/2021 10:37
1744,1982-01-03,Thomasville,Wisconsin,29634,4760,4760,0,10/3/2020 11:53,1/12/2022 18:03
1745,1973-09-22,Thomasville,Wyoming,29634,620,620,0,10/3/2020 12:10,2/28/2022 19:26
1746,1976-10-04,Thomasville,Alabama,29634,735,735,0,10/3/2020 12:53,4/7/2022 18:01
1747,1965-04-02,Thomasville,Alaska,29634,700,700,0,10/3/2020 13:21,
1748,1986-09-25,Thomasville,Arizona,29634,1100,1100,0,10/3/2020 13:33,10/14/2020 18:27
1749,1977-11-25,Thomasville,Arkansas,29634,7045,7045,0,10/3/2020 13:45,4/7/2022 18:00
1750,1966-10-21,Thomasville,California,29634,400,400,0,10/3/2020 14:47,
1751,1961-08-12,Thomasville,Colorado,29634,450,850,400,10/3/2020 16:01,1/22/2022 21:39
1752,1991-04-25,Thomasville,Connecticut,29634,145,1145,1000,10/3/2020 16:04,5/16/2021 20:02
1753,1987-11-20,Charlotte,North Carolina,28207,975,1285,310,10/3/2020 17:58,4/8/2022 22:07
1754,1951-11-28,Thomasville,Delaware,29634,3120,3620,500,10/3/2020 18:24,4/18/2022 18:01
1755,1992-10-11,Thomasville,District of Columbia,29634,610,610,0,10/3/2020 18:26,10/16/2021 19:05
1756,1986-08-28,Thomasville,Florida,29634,1900,1900,0,10/3/2020 18:38,5/3/2022 18:18
1757,2000-03-24,Winston-Salem,North Carolina,27106,2315,2315,0,10/3/2020 18:49,5/18/2022 12:01
1758,1991-07-15,Thomasville,Georgia,29634,1580,1580,0,10/3/2020 19:06,5/10/2022 18:53
1759,1956-01-26,Long valley ,New Jersey,7853,395,1395,1000,10/3/2020 19:18,2/26/2022 18:59
1760,1956-05-23,Thomasville,Hawaii,29634,1410,1410,0,10/3/2020 19:18,4/18/2022 16:38
1761,1951-03-11,Thomasville,Idaho,29634,3270,4570,1300,10/3/2020 20:03,5/11/2022 19:41
1762,1953-03-20,Thomasville,Illinois,29634,580,980,400,10/3/2020 20:32,3/25/2022 11:05
1763,1991-02-19,Thomasville,Indiana,29634,700,1000,300,10/3/2020 22:14,2/19/2022 12:49
1764,1981-07-27,Thomasville,Iowa,29634,800,800,0,10/3/2020 23:50,1/22/2022 19:51
1765,1953-02-13,Thomasville,Kansas,29634,700,700,0,10/4/2020 1:44,
1766,1961-04-09,Thomasville,Kentucky,29634,400,700,300,10/4/2020 10:16,3/2/2021 10:25
1767,1964-11-16,Thomasville,Louisiana,29634,1060,1060,0,10/4/2020 12:46,4/14/2022 15:36
1768,1951-10-10,Thomasville,Maine,29634,1850,1850,0,10/4/2020 12:48,3/18/2022 23:12
1769,1954-11-01,Thomasville,Maryland,29634,1025,1025,0,10/4/2020 12:50,11/15/2021 8:42
1770,1984-10-14,Thomasville,Massachusetts,29634,685,685,0,10/4/2020 12:50,4/30/2021 14:54
1771,2003-11-15,Thomasville,Michigan,29634,2815,2815,0,10/4/2020 13:07,3/23/2022 20:19
1772,1999-03-28,Thomasville,Minnesota,29634,700,1000,300,10/4/2020 13:08,1/23/2021 11:54
1773,1999-04-30,Thomasville,Mississippi,29634,390,690,300,10/4/2020 13:09,5/21/2021 13:25
1774,1997-09-12,Rich Square ,North Carolina,27869,1180,4030,2850,10/4/2020 13:43,8/8/2021 12:07
1775,1959-06-09,Thomasville,Missouri,29634,1930,1930,0,10/4/2020 13:49,1/28/2022 17:03
1776,1971-04-05,Thomasville,Montana,29634,2810,2810,0,10/4/2020 14:17,3/19/2022 13:52
1777,1959-09-22,Thomasville,Nebraska,29634,1220,2220,1000,10/4/2020 14:24,5/4/2022 10:25
1778,1969-07-18,Thomasville,Nevada,29634,1100,1100,0,10/4/2020 16:41,1/22/2022 21:35
1779,2003-06-24,Thomasville,New Hampshire,29634,1370,1370,0,10/4/2020 18:48,6/8/2022 9:31
1780,1981-02-19,Thomasville,New Jersey,29634,730,730,0,10/4/2020 19:00,5/8/2021 18:34
1781,1965-08-02,Thomasville,New Mexico,29634,1320,1320,0,10/4/2020 19:49,12/8/2021 18:43
1782,1960-09-02,Thomasville,New York,29634,1490,1490,0,10/5/2020 11:47,4/18/2022 11:19
1783,1967-06-08,Thomasville,North Carolina,29634,980,980,0,10/5/2020 12:03,4/8/2022 9:34
1784,1988-10-17,Thomasville,North Dakota,29634,560,560,0,10/5/2020 14:43,4/8/2022 18:54
1785,1997-06-04,Thomasville,Ohio,29634,500,500,0,10/5/2020 14:44,11/13/2021 18:45
1786,2001-06-28,Thomasville,Oklahoma,29634,700,700,0,10/5/2020 15:50,11/27/2020 17:00
1787,1980-12-17,Thomasville,Oregon,29634,1920,1920,0,10/5/2020 16:46,5/3/2022 17:43
1788,1967-09-19,Thomasville,Pennsylvania,29634,650,650,0,10/6/2020 9:31,1/11/2022 13:01
1789,2001-06-15,Thomasville,Rhode Island,29634,1050,1500,450,10/6/2020 12:41,2/12/2022 14:58
1790,1969-10-19,Thomasville,South Carolina,29634,4490,4490,0,10/6/2020 14:11,12/4/2021 20:25
1791,2005-12-18,Thomasville,South Dakota,29634,625,625,0,10/6/2020 15:56,9/18/2021 21:29
1792,1964-02-18,Thomasville,Tennessee,29634,2420,2420,0,10/6/2020 18:28,2/19/2022 13:59
1793,1999-04-12,Thomasville,Texas,29634,1565,1565,0,10/6/2020 18:32,2/3/2022 18:41
1794,1989-09-19,Thomasville,Utah,29634,3395,3895,500,10/6/2020 19:28,4/11/2022 12:07
1795,1964-07-11,Thomasville,Vermont,29634,2350,2350,0,10/6/2020 19:31,2/12/2022 14:39
1796,1971-09-08,Thomasville,Virginia,29634,700,700,0,10/6/2020 20:21,
1797,1990-02-14,Thomasville,Washington,29634,700,700,0,10/6/2020 20:25,2/22/2022 9:55
1798,1954-05-22,Thomasville,West Virginia,29634,2720,2720,0,10/6/2020 20:25,6/12/2022 23:05
1799,2003-07-06,Thomasville,Wisconsin,29634,500,500,0,10/6/2020 21:41,1/22/2022 20:03
1800,1995-09-05,Thomasville,Wyoming,29634,2970,3970,1000,10/7/2020 8:04,8/22/2021 9:57
1801,1981-11-08,Thomasville,Alabama,29634,880,880,0,10/7/2020 9:07,6/6/2022 15:40
1802,1973-07-13,Thomasville,Alaska,29634,100,400,300,10/7/2020 9:53,
1803,1981-01-01,Thomasville,Arizona,29634,950,950,0,10/7/2020 10:15,3/19/2022 0:43
1804,1999-08-18,Thomasville,Arkansas,29634,400,400,0,10/7/2020 10:16,1/22/2022 12:25
1805,1998-11-27,Thomasville,California,29634,900,900,0,10/7/2020 11:04,2/10/2022 9:02
1806,1956-11-17,Thomasville,Colorado,29634,2945,2945,0,10/7/2020 11:48,5/8/2022 12:24
1807,1984-12-16,Thomasville,Connecticut,29634,720,720,0,10/7/2020 18:24,11/27/2021 16:09
1808,1960-09-01,Thomasville,Delaware,29634,600,600,0,10/7/2020 19:00,11/13/2021 19:36
1809,1967-09-21,Thomasville,District of Columbia,29634,450,750,300,10/7/2020 22:10,3/2/2022 22:08
1810,1989-10-17,Thomasville,Florida,29634,770,770,0,10/8/2020 9:54,5/13/2021 10:41
1811,2002-11-12,Thomasville,Georgia,29634,7530,8530,1000,10/8/2020 9:56,7/1/2022 6:12
1812,1984-02-06,Thomasville,Hawaii,29634,3040,4040,1000,10/8/2020 10:18,4/27/2022 18:57
1813,1996-11-10,Thomasville,Idaho,29634,2150,2150,0,10/8/2020 10:34,3/16/2022 21:33
1814,1993-12-21,Thomasville,Illinois,29634,700,700,0,10/8/2020 12:00,
1815,1984-03-22,Thomasville,Indiana,29634,700,700,0,10/8/2020 12:01,10/13/2020 21:46
1816,1998-08-14,Thomasville,Iowa,29634,285,1085,800,10/8/2020 15:37,10/20/2020 10:44
1817,1964-06-21,Thomasville,Kansas,29634,1000,1000,0,10/8/2020 16:29,5/15/2021 19:19
1818,1968-01-06,Thomasville,Kentucky,29634,0,700,700,10/8/2020 18:26,3/4/2021 12:54
1819,1951-09-14,Thomasville,Louisiana,29634,1030,1030,0,10/8/2020 19:16,1/22/2022 18:07
1820,2000-07-20,Thomasville,Maine,29634,1265,2065,800,10/8/2020 22:32,5/12/2021 16:37
1821,1998-02-06,Thomasville,Maryland,29634,4115,5115,1000,10/8/2020 22:37,3/9/2022 16:26
1822,1967-10-01,Thomasville,Massachusetts,29634,500,500,0,10/9/2020 9:31,1/22/2022 19:19
1823,1953-08-23,Thomasville,Michigan,29634,550,550,0,10/9/2020 10:34,12/2/2021 16:23
1824,1982-10-16,Thomasville,Minnesota,29634,500,500,0,10/9/2020 10:41,3/16/2022 15:40
1825,1965-06-16,Thomasville,Mississippi,29634,5260,5260,0,10/9/2020 11:07,5/6/2022 17:07
1826,2002-03-28,Thomasville,Missouri,29634,380,880,500,10/9/2020 16:43,4/7/2022 17:58
1827,1992-05-06,Thomasville,Montana,29634,2050,2050,0,10/9/2020 18:22,11/20/2021 15:36
1828,1988-06-15,Thomasville,Nebraska,29634,5870,6170,300,10/10/2020 19:34,5/19/2022 0:41
1829,1959-11-06,Thomasville,Nevada,29634,4080,4080,0,10/10/2020 19:37,5/5/2022 14:07
1830,1969-03-14,Thomasville,New Hampshire,29634,1530,2030,500,10/10/2020 22:02,12/2/2021 17:00
1831,2002-02-21,Thomasville,New Jersey,29634,6010,6610,600,10/11/2020 11:17,8/20/2021 8:39
1832,1973-01-01,Thomasville,New Mexico,29634,700,700,0,10/11/2020 12:36,10/20/2020 8:27
1833,2002-02-24,Thomasville,New York,29634,1145,1145,0,10/11/2020 12:55,10/14/2020 13:32
1834,1998-08-03,Thomasville,North Carolina,29634,605,4155,3550,10/11/2020 12:57,4/29/2021 13:18
1835,1978-10-16,Winston-Salem ,North Carolina,27106,725,775,50,10/11/2020 13:42,12/10/2020 17:05
1836,2001-09-24,Thomasville,North Dakota,29634,8020,8320,300,10/11/2020 17:34,4/12/2022 9:27
1837,1959-01-27,Thomasville,Ohio,29634,0,700,700,10/11/2020 19:28,11/23/2021 10:00
1838,1975-08-06,Thomasville,Oklahoma,29634,400,400,0,10/11/2020 19:46,3/13/2022 22:16
1839,1953-05-26,Thomasville,Oregon,29634,500,800,300,10/11/2020 20:05,10/14/2020 10:42
1840,2003-12-22,Thomasville,Pennsylvania,29634,450,450,0,10/11/2020 20:11,2/12/2022 15:22
1841,1961-12-03,Thomasville,Rhode Island,29634,670,670,0,10/11/2020 20:14,4/20/2022 8:57
1842,1998-10-26,Thomasville,South Carolina,29634,2175,10175,8000,10/11/2020 20:43,9/11/2021 15:15
1843,1999-05-03,Thomasville,South Dakota,29634,3385,3385,0,10/11/2020 20:46,8/24/2021 19:02
1844,1990-05-02,Ashburn,Virginia,20147,1415,5915,4500,10/11/2020 20:50,5/10/2021 18:28
1845,2002-02-03,Littleton,Colorado,80123,4670,4970,300,10/11/2020 20:52,6/30/2022 18:25
1846,1977-06-05,Thomasville,Tennessee,29634,750,750,0,10/11/2020 21:52,2/26/2021 17:07
1847,1971-09-03,Thomasville,Texas,29634,1100,1100,0,10/11/2020 22:36,2/26/2022 19:32
1848,1951-01-19,Thomasville,Utah,29634,750,750,0,10/11/2020 22:39,11/11/2021 19:59
1849,1977-11-26,Thomasville,Vermont,29634,700,700,0,10/11/2020 22:50,10/14/2020 11:47
1850,1975-07-22,Thomasville,Virginia,29634,120,720,600,10/12/2020 8:47,10/1/2021 10:00
1851,1972-11-08,Thomasville,Washington,29634,700,1000,300,10/12/2020 8:55,1/12/2022 13:53
1852,2002-04-17,Thomasville,West Virginia,29634,2700,2700,0,10/12/2020 9:05,2/26/2022 18:52
1853,1960-04-07,Thomasville,Wisconsin,29634,820,1120,300,10/12/2020 9:13,5/13/2022 13:25
1854,1956-08-03,Thomasville,Wyoming,29634,1200,1200,0,10/12/2020 9:14,3/25/2022 18:21
1855,1955-04-10,Thomasville,Alabama,29634,500,500,0,10/12/2020 9:22,2/18/2022 9:00
1856,1953-05-06,Thomasville,Alaska,29634,2300,2300,0,10/12/2020 9:37,3/24/2022 16:10
1857,1974-12-27,Thomasville,Arizona,29634,2090,2090,0,10/12/2020 10:01,4/19/2022 19:22
1858,2000-08-11,Thomasville,Arkansas,29634,1910,1910,0,10/12/2020 10:03,4/19/2022 18:33
1859,1989-04-11,Thomasville,California,29634,1780,1780,0,10/12/2020 10:06,4/20/2022 10:42
1860,1992-12-19,Thomasville,Colorado,29634,190,790,600,10/12/2020 10:14,6/21/2022 19:42
1861,1998-12-18,Thomasville,Connecticut,29634,980,980,0,10/12/2020 10:14,5/12/2021 19:42
1862,1968-09-13,Thomasville,Delaware,29634,820,820,0,10/12/2020 10:17,5/5/2022 22:26
1863,1978-05-16,Thomasville,District of Columbia,29634,2045,2045,0,10/12/2020 10:22,3/27/2022 19:17
1864,1970-06-16,Thomasville,Florida,29634,400,400,0,10/12/2020 10:24,1/22/2022 14:40
1865,1989-02-07,Thomasville,Georgia,29634,810,810,0,10/12/2020 10:25,4/8/2022 17:59
1866,1963-11-21,Thomasville,Hawaii,29634,960,960,0,10/12/2020 10:27,4/29/2021 21:23
1867,1985-06-21,Thomasville,Idaho,29634,710,710,0,10/12/2020 10:32,4/26/2021 14:07
1868,1992-01-02,Thomasville,Illinois,29634,4090,4090,0,10/12/2020 10:37,4/12/2022 19:28
1869,1962-06-26,Thomasville,Indiana,29634,1395,1395,0,10/12/2020 10:44,2/17/2022 13:47
1870,1987-01-02,Thomasville,Iowa,29634,1820,1820,0,10/12/2020 10:54,4/16/2022 14:32
1871,1951-02-15,Thomasville,Kansas,29634,1375,1375,0,10/12/2020 10:58,1/13/2022 7:55
1872,1968-06-15,Thomasville,Kentucky,29634,800,800,0,10/12/2020 11:02,3/30/2022 8:50
1873,1983-06-08,Thomasville,Louisiana,29634,1050,1050,0,10/12/2020 11:06,3/2/2022 20:45
1874,1976-09-18,Thomasville,Maine,29634,160,660,500,10/12/2020 11:24,5/19/2022 23:08
1875,1950-08-19,Thomasville,Maryland,29634,630,630,0,10/12/2020 11:41,5/11/2022 17:03
1876,2005-01-14,Thomasville,Massachusetts,29634,700,700,0,10/12/2020 11:42,11/27/2021 15:50
1877,1973-05-16,Thomasville,Michigan,29634,2470,2470,0,10/12/2020 11:48,4/16/2022 16:01
1878,1958-03-21,Thomasville,Minnesota,29634,960,960,0,10/12/2020 11:49,4/29/2022 16:20
1879,1960-09-25,Thomasville,Mississippi,29634,1800,2300,500,10/12/2020 11:57,5/2/2022 7:58
1880,1992-10-05,Thomasville,Missouri,29634,530,830,300,10/12/2020 11:58,4/28/2022 15:17
1881,2004-08-15,Thomasville,Montana,29634,410,710,300,10/12/2020 12:03,6/6/2021 19:56
1882,1954-09-24,Thomasville,Nebraska,29634,700,700,0,10/12/2020 12:03,10/16/2020 12:01
1883,1985-10-27,Thomasville,Nevada,29634,2010,2010,0,10/12/2020 12:06,4/4/2022 22:26
1884,2004-03-21,Thomasville,New Hampshire,29634,1500,2500,1000,10/12/2020 12:09,5/11/2022 18:19
1885,1999-02-06,Thomasville,New Jersey,29634,1275,1275,0,10/12/2020 12:13,5/2/2021 0:43
1886,2005-01-24,Thomasville,New Mexico,29634,350,950,600,10/12/2020 12:24,3/7/2022 14:54
1887,1999-02-05,Thomasville,New York,29634,7875,7875,0,10/12/2020 12:30,6/16/2022 8:18
1888,1998-11-13,Thomasville,North Carolina,29634,1680,1680,0,10/12/2020 12:41,6/12/2021 2:06
1889,2001-03-17,Thomasville,North Dakota,29634,970,970,0,10/12/2020 12:41,4/26/2021 21:17
1890,1987-10-26,Thomasville,Ohio,29634,650,650,0,10/12/2020 12:43,11/5/2021 12:40
1891,1969-04-07,Thomasville,Oklahoma,29634,1090,1090,0,10/12/2020 12:47,5/17/2021 0:32
1892,2003-12-27,Thomasville,Oregon,29634,530,830,300,10/12/2020 12:48,4/15/2022 14:11
1893,1963-11-18,Thomasville,Pennsylvania,29634,1000,1000,0,10/12/2020 12:52,5/7/2021 1:53
1894,2002-01-01,Thomasville,Rhode Island,29634,750,750,0,10/12/2020 12:54,11/27/2020 17:02
1895,1993-01-26,Thomasville,South Carolina,29634,720,720,0,10/12/2020 12:55,4/27/2021 18:28
1896,2005-03-09,Thomasville,South Dakota,29634,960,960,0,10/12/2020 12:57,4/27/2021 19:25
1897,1966-10-13,Thomasville,Tennessee,29634,760,760,0,10/12/2020 12:57,5/3/2021 14:15
1898,1995-06-20,Thomasville,Texas,29634,1260,1260,0,10/12/2020 12:57,5/3/2022 19:47
1899,1986-07-12,Thomasville,Utah,29634,730,730,0,10/12/2020 12:57,9/3/2021 10:00
1900,1972-08-02,Thomasville,Vermont,29634,400,700,300,10/12/2020 13:02,
1901,1968-07-03,Thomasville,Virginia,29634,95,595,500,10/12/2020 13:03,6/30/2022 11:02
1902,1959-09-23,Thomasville,Washington,29634,460,760,300,10/12/2020 13:05,11/27/2021 21:39
1903,1951-07-28,Thomasville,West Virginia,29634,850,850,0,10/12/2020 13:08,10/15/2020 14:57
1904,1973-05-17,Thomasville,Wisconsin,29634,740,740,0,10/12/2020 13:08,5/9/2021 14:04
1905,2000-03-09,Thomasville,Wyoming,29634,410,710,300,10/12/2020 13:09,4/26/2021 21:18
1906,2000-07-30,Thomasville,Alabama,29634,1625,3625,2000,10/12/2020 13:12,3/2/2022 20:22
1907,1955-08-04,Thomasville,Alaska,29634,1010,1010,0,10/12/2020 13:12,5/7/2021 11:46
1908,1969-12-04,Thomasville,Arizona,29634,700,700,0,10/12/2020 13:12,10/12/2020 14:38
1909,1954-08-07,Thomasville,Arkansas,29634,1100,1400,300,10/12/2020 13:25,3/25/2022 18:28
1910,1954-05-04,Thomasville,California,29634,810,810,0,10/12/2020 13:30,6/30/2022 9:43
1911,1982-12-15,Thomasville,Colorado,29634,3190,3190,0,10/12/2020 13:30,6/30/2022 9:39
1912,1964-02-14,Thomasville,Connecticut,29634,410,410,0,10/12/2020 13:32,3/2/2022 9:15
1913,2000-10-03,Thomasville,Delaware,29634,850,850,0,10/12/2020 13:32,5/5/2021 12:38
1914,2001-09-04,Thomasville,District of Columbia,29634,1520,1520,0,10/12/2020 13:34,4/15/2022 19:06
1915,2002-01-24,Thomasville,Florida,29634,400,400,0,10/12/2020 13:35,3/19/2022 12:01
1916,1974-10-23,Thomasville,Georgia,29634,1630,2130,500,10/12/2020 13:36,6/17/2022 17:07
1917,1999-09-15,Thomasville,Hawaii,29634,790,2790,2000,10/12/2020 13:39,3/25/2022 18:29
1918,1984-03-02,Thomasville,Idaho,29634,700,700,0,10/12/2020 13:41,
1919,1978-02-11,Thomasville,Illinois,29634,2235,2235,0,10/12/2020 13:44,5/3/2022 17:52
1920,1999-10-23,Thomasville,Indiana,29634,1070,1070,0,10/12/2020 13:59,9/9/2021 10:35
1921,1975-01-13,Thomasville,Iowa,29634,700,700,0,10/12/2020 14:01,10/20/2020 23:26
1922,1998-05-15,Thomasville,Kansas,29634,2860,3360,500,10/12/2020 14:04,3/20/2022 14:46
1923,1978-06-27,Thomasville,Kentucky,29634,425,725,300,10/12/2020 14:07,2/27/2021 2:17
1924,1994-02-23,Thomasville,Louisiana,29634,1080,1080,0,10/12/2020 14:12,5/9/2021 11:51
1925,1982-04-15,Thomasville,Maine,29634,710,710,0,10/12/2020 14:29,5/8/2021 13:15
1926,1959-08-06,Thomasville,Maryland,29634,780,780,0,10/12/2020 14:30,5/2/2021 20:12
1927,1973-09-17,Thomasville,Massachusetts,29634,3500,3500,0,10/12/2020 14:39,1/31/2022 15:25
1928,1965-04-16,Thomasville,Michigan,29634,710,710,0,10/12/2020 14:43,5/30/2021 12:57
1929,1962-01-25,Thomasville,Minnesota,29634,710,710,0,10/12/2020 14:49,6/4/2021 15:54
1930,1992-10-23,Thomasville,Mississippi,29634,710,710,0,10/12/2020 14:54,10/19/2020 9:23
1931,1974-09-03,Thomasville,Missouri,29634,700,700,0,10/12/2020 15:08,10/12/2020 15:10
1932,1969-09-03,Thomasville,Montana,29634,700,700,0,10/12/2020 15:10,
1933,1954-10-02,Thomasville,Nebraska,29634,770,770,0,10/12/2020 15:12,5/9/2021 12:36
1934,1984-03-03,Thomasville,Nevada,29634,400,400,0,10/12/2020 15:25,11/27/2021 19:01
1935,2002-09-24,Thomasville,New Hampshire,29634,400,400,0,10/12/2020 15:27,
1936,1982-07-11,Thomasville,New Jersey,29634,100,400,300,10/12/2020 15:28,1/21/2022 20:37
1937,1971-07-25,Thomasville,New Mexico,29634,620,620,0,10/12/2020 16:16,3/19/2022 15:45
1938,1985-01-22,Thomasville,New York,29634,700,700,0,10/12/2020 16:52,10/16/2020 1:09
1939,1955-02-03,Thomasville,North Carolina,29634,700,700,0,10/12/2020 17:04,
1940,2004-11-06,Thomasville,North Dakota,29634,800,800,0,10/12/2020 17:11,2/7/2022 18:37
1941,1999-05-27,Thomasville,Ohio,29634,1445,1445,0,10/12/2020 17:16,10/21/2020 9:14
1942,1998-10-01,Thomasville,Oklahoma,29634,1285,1285,0,10/12/2020 17:19,4/30/2021 15:30
1943,1966-08-08,Thomasville,Oregon,29634,900,900,0,10/12/2020 17:19,10/21/2020 10:48
1944,1961-03-27,Thomasville,Pennsylvania,29634,2370,2370,0,10/12/2020 17:46,3/25/2022 22:14
1945,1979-03-06,Thomasville,Rhode Island,29634,700,700,0,10/12/2020 17:49,10/19/2020 8:33
1946,1966-06-04,Thomasville,South Carolina,29634,710,710,0,10/12/2020 18:00,4/16/2022 17:12
1947,2005-04-25,Thomasville,South Dakota,29634,710,710,0,10/12/2020 18:41,5/8/2021 13:14
1948,1985-02-09,Thomasville,Tennessee,29634,855,855,0,10/12/2020 18:48,2/25/2022 18:10
1949,1984-10-18,Thomasville,Texas,29634,800,800,0,10/12/2020 18:55,10/12/2020 18:56
1950,2004-05-24,Thomasville,Utah,29634,450,450,0,10/12/2020 19:02,1/10/2022 9:02
1951,1980-08-12,Thomasville,Vermont,29634,1350,1350,0,10/12/2020 19:11,3/30/2022 12:04
1952,2002-09-13,Atlanta,Georgia,30311,660,660,0,10/12/2020 19:14,2/28/2022 16:07
1953,1971-03-22,Thomasville,Virginia,29634,375,675,300,10/12/2020 19:15,3/13/2022 11:32
1954,1990-03-06,Thomasville,Washington,29634,410,710,300,10/12/2020 19:16,6/12/2022 3:10
1955,2002-01-14,Thomasville,West Virginia,29634,100,400,300,10/12/2020 19:17,10/17/2020 15:58
1956,1977-08-07,Thomasville,Wisconsin,29634,400,400,0,10/12/2020 19:19,1/25/2022 13:18
1957,2000-09-19,Thomasville,Wyoming,29634,460,760,300,10/12/2020 19:27,5/8/2021 15:35
1958,1951-02-04,Thomasville,Alabama,29634,750,750,0,10/12/2020 19:34,10/19/2020 8:43
1959,1972-08-24,Thomasville,Alaska,29634,750,750,0,10/12/2020 19:41,11/27/2021 16:52
1960,1967-06-13,Thomasville,Arizona,29634,460,460,0,10/12/2020 19:48,5/9/2022 18:01
1961,2001-10-16,Thomasville,Arkansas,29634,1525,1525,0,10/12/2020 19:53,3/15/2022 19:00
1962,1955-08-10,Thomasville,California,29634,370,1270,900,10/12/2020 19:57,5/2/2021 22:42
1963,2003-06-24,Thomasville,Colorado,29634,1060,1060,0,10/12/2020 19:57,5/11/2021 9:34
1964,1976-09-08,Thomasville,Connecticut,29634,700,700,0,10/12/2020 20:01,10/21/2020 13:01
1965,1964-01-21,Thomasville,Delaware,29634,3180,3380,200,10/12/2020 20:14,3/25/2022 18:46
1966,2004-09-03,Winston-Salem ,North Carolina,27106,10,610,600,10/12/2020 20:28,2/18/2022 13:00
1967,1953-11-21,Thomasville,District of Columbia,29634,650,650,0,10/12/2020 20:52,1/22/2022 19:01
1968,1951-08-03,Thomasville,Florida,29634,620,620,0,10/12/2020 21:08,4/11/2022 14:05
1969,1954-01-04,Thomasville,Georgia,29634,0,500,500,10/12/2020 21:10,1/25/2022 19:06
1970,1958-07-08,Thomasville,Hawaii,29634,550,550,0,10/12/2020 21:14,2/16/2022 9:04
1971,1983-08-01,Thomasville,Idaho,29634,1530,1530,0,10/12/2020 21:34,6/29/2022 21:00
1972,1996-12-01,Thomasville,Illinois,29634,700,700,0,10/12/2020 21:43,10/21/2020 0:59
1973,1983-07-19,Thomasville,Indiana,29634,1250,1250,0,10/12/2020 21:45,3/19/2022 16:04
1974,1954-04-14,Thomasville,Iowa,29634,800,800,0,10/12/2020 21:51,3/16/2022 15:48
1975,1954-01-18,Thomasville,Kansas,29634,500,500,0,10/12/2020 22:02,3/5/2022 14:30
1976,1987-09-17,Thomasville,Kentucky,29634,1110,1110,0,10/12/2020 22:03,4/3/2022 13:56
1977,1966-06-28,Winston-Salem ,North Carolina,27109,1190,1200,10,10/12/2020 22:04,3/1/2022 12:00
1978,1959-03-09,Thomasville,Louisiana,29634,210,510,300,10/12/2020 22:05,4/8/2022 20:06
1979,2000-10-18,Thomasville,Maine,29634,350,650,300,10/12/2020 22:11,2/25/2022 22:44
1980,1953-03-13,Thomasville,Maryland,29634,750,750,0,10/12/2020 22:18,3/13/2022 22:35
1981,2002-12-10,Thomasville,Massachusetts,29634,750,750,0,10/12/2020 22:20,3/25/2022 18:58
1982,1961-08-18,Thomasville,Michigan,29634,700,700,0,10/12/2020 22:47,11/15/2020 15:02
1983,1972-09-11,Thomasville,Minnesota,29634,1250,1250,0,10/12/2020 22:49,1/12/2022 19:23
1984,1990-07-17,Thomasville,Mississippi,29634,710,710,0,10/12/2020 22:54,5/12/2021 12:09
1985,1963-01-09,Thomasville,Missouri,29634,700,700,0,10/12/2020 22:56,10/20/2020 20:01
1986,1963-04-28,Thomasville,Montana,29634,1310,1310,0,10/12/2020 23:01,5/11/2022 18:52
1987,1983-06-03,Thomasville,Nebraska,29634,340,640,300,10/12/2020 23:01,5/11/2022 19:09
1988,1993-03-22,Thomasville,Nevada,29634,1230,1230,0,10/12/2020 23:03,6/5/2022 9:48
1989,1976-04-20,Thomasville,New Hampshire,29634,1950,2950,1000,10/12/2020 23:05,3/16/2022 17:15
1990,2000-09-15,Thomasville,New Jersey,29634,600,600,0,10/12/2020 23:08,3/30/2022 11:00
1991,1962-12-25,Thomasville,New Mexico,29634,600,600,0,10/12/2020 23:10,
1992,1970-09-04,Thomasville,New York,29634,700,1000,300,10/12/2020 23:26,10/20/2020 12:00
1993,1972-02-02,Thomasville,North Carolina,29634,590,1090,500,10/12/2020 23:32,1/22/2022 19:49
1994,1977-08-15,Thomasville,North Dakota,29634,1100,1100,0,10/12/2020 23:33,2/19/2022 13:12
1995,2002-03-02,Thomasville,Ohio,29634,700,700,0,10/12/2020 23:34,10/5/2021 15:56
1996,1999-12-21,Thomasville,Oklahoma,29634,2150,2150,0,10/12/2020 23:36,4/19/2022 17:36
1997,1969-03-24,Thomasville,Oregon,29634,1250,1250,0,10/13/2020 0:07,12/4/2021 23:20
1998,1958-10-08,Thomasville,Pennsylvania,29634,710,710,0,10/13/2020 0:07,5/7/2021 22:24
1999,1959-08-15,Thomasville,Rhode Island,29634,1410,1410,0,10/13/2020 1:32,6/30/2022 18:55
2000,1950-03-03,Thomasville,South Carolina,29634,1350,1350,0,10/13/2020 9:16,1/22/2022 19:33
2001,1984-12-04,Thomasville,South Dakota,29634,1410,1410,0,10/13/2020 9:19,4/15/2022 19:00
2002,1982-01-07,Thomasville,Tennessee,29634,400,700,300,10/13/2020 9:24,10/18/2020 21:19
2003,1999-06-04,Thomasville,Texas,29634,5650,5950,300,10/13/2020 10:16,5/11/2022 18:17
2004,1992-06-14,Thomasville,Utah,29634,1350,1350,0,10/13/2020 10:18,3/25/2022 13:02
2005,1977-11-27,Thomasville,Vermont,29634,940,940,0,10/13/2020 10:19,5/11/2022 13:01
2006,1956-01-10,Raleigh,North Carolina,27615,470,1270,800,10/13/2020 10:23,2/28/2022 11:10
2007,1981-05-10,Thomasville,Virginia,29634,1490,1490,0,10/13/2020 10:24,5/4/2022 22:38
2008,1968-08-22,Thomasville,Washington,29634,500,500,0,10/13/2020 10:29,1/22/2022 18:56
2009,1999-10-24,Thomasville,West Virginia,29634,710,710,0,10/13/2020 10:50,1/23/2022 9:44
2010,1974-03-28,Thomasville,Wisconsin,29634,400,700,300,10/13/2020 10:50,
2011,1952-02-17,Thomasville,Wyoming,29634,5700,5700,0,10/13/2020 10:59,4/11/2022 14:02
2012,1968-12-22,Thomasville,Alabama,29634,520,520,0,10/13/2020 11:05,5/9/2022 20:12
2013,1992-02-16,Thomasville,Alaska,29634,750,750,0,10/13/2020 11:05,3/25/2022 16:43
2014,1961-01-28,Thomasville,Arizona,29634,210,710,500,10/13/2020 11:05,6/27/2022 23:40
2015,1997-09-14,Thomasville,Arkansas,29634,2950,2950,0,10/13/2020 11:06,3/24/2022 18:06
2016,2001-01-09,Thomasville,California,29634,1330,1330,0,10/13/2020 11:07,1/16/2022 13:21
2017,1995-09-09,Thomasville,Colorado,29634,550,550,0,10/13/2020 11:08,2/26/2022 18:03
2018,2005-12-06,Thomasville,Connecticut,29634,900,900,0,10/13/2020 11:11,4/23/2022 9:14
2019,2000-05-23,Thomasville,Delaware,29634,450,450,0,10/13/2020 11:13,1/10/2022 14:23
2020,1964-02-23,Thomasville,District of Columbia,29634,640,640,0,10/13/2020 11:35,5/3/2022 19:26
2021,1994-01-21,Winston-Salem,North Carolina,27101,740,760,20,10/13/2020 11:36,3/15/2022 10:46
2022,1976-10-22,Thomasville,Florida,29634,700,700,0,10/13/2020 11:39,
2023,1968-05-08,Thomasville,Georgia,29634,1210,1210,0,10/13/2020 11:40,4/8/2022 11:44
2024,1983-12-13,Thomasville,Hawaii,29634,400,400,0,10/13/2020 11:40,10/13/2020 11:42
2025,1977-11-10,Thomasville,Idaho,29634,810,810,0,10/13/2020 11:40,10/20/2020 20:13
2026,2002-10-26,Thomasville,Illinois,29634,955,1255,300,10/13/2020 11:45,3/14/2022 10:48
2027,1996-06-27,Thomasville,Indiana,29634,610,610,0,10/13/2020 11:50,4/17/2022 14:54
2028,1978-01-16,Thomasville,Iowa,29634,630,630,0,10/13/2020 11:58,5/4/2022 10:50
2029,2005-10-19,Thomasville,Kansas,29634,1460,1760,300,10/13/2020 12:06,5/3/2022 13:00
2030,1954-08-05,Thomasville,Kentucky,29634,700,700,0,10/13/2020 12:16,11/9/2020 9:02
2031,2005-06-26,Thomasville,Louisiana,29634,700,700,0,10/13/2020 12:17,
2032,1984-09-13,Thomasville,Maine,29634,1480,1480,0,10/13/2020 12:20,5/11/2022 19:33
2033,1967-12-05,Thomasville,Maryland,29634,700,700,0,10/13/2020 12:21,
2034,1986-04-18,Thomasville,Massachusetts,29634,700,700,0,10/13/2020 12:26,10/13/2020 12:44
2035,2001-02-24,Thomasville,Michigan,29634,1710,1710,0,10/13/2020 12:31,4/15/2022 13:10
2036,1957-10-24,Thomasville,Minnesota,29634,620,620,0,10/13/2020 12:32,4/13/2022 9:00
2037,1953-02-25,Thomasville,Mississippi,29634,850,850,0,10/13/2020 12:39,1/29/2022 16:22
2038,1967-06-22,Thomasville,Missouri,29634,710,710,0,10/13/2020 12:43,5/9/2021 12:50
2039,1951-06-05,Thomasville,Montana,29634,345,345,0,10/13/2020 12:47,5/7/2021 19:17
2040,1999-07-13,Thomasville,Nebraska,29634,710,710,0,10/13/2020 12:57,10/13/2020 14:36
2041,1986-01-01,Thomasville,Nevada,29634,700,700,0,10/13/2020 13:01,10/16/2020 22:40
2042,1971-03-12,Thomasville,New Hampshire,29634,500,500,0,10/13/2020 13:05,8/31/2021 19:08
2043,2002-03-14,dover,Massachusetts,2030,900,910,10,10/13/2020 13:09,2/22/2022 21:19
2044,1966-06-27,Thomasville,New Jersey,29634,1320,1320,0,10/13/2020 13:21,2/19/2022 12:34
2045,1998-09-16,Thomasville,New Mexico,29634,1560,1560,0,10/13/2020 13:24,5/2/2021 19:55
2046,1981-04-12,Thomasville,New York,29634,670,1670,1000,10/13/2020 13:51,1/22/2022 19:45
2047,1978-05-06,Thomasville,North Carolina,29634,400,400,0,10/13/2020 14:09,3/16/2022 18:46
2048,1989-06-25,Thomasville,North Dakota,29634,1710,1710,0,10/13/2020 14:26,4/30/2022 16:42
2049,1950-02-23,Thomasville,Ohio,29634,750,750,0,10/13/2020 14:32,
2050,1984-10-17,Thomasville,Oklahoma,29634,750,750,0,10/13/2020 14:42,
2051,2001-06-07,Thomasville,Oregon,29634,300,800,500,10/13/2020 14:47,3/16/2022 10:58
2052,1976-02-12,Winston-Salem,North Carolina,27106,1200,1400,200,10/13/2020 14:51,3/2/2022 21:01
2053,1982-08-26,Baltimore,Maryland,21218,1535,1870,335,10/13/2020 14:51,5/11/2022 19:11
2054,1972-08-04,Thomasville,Pennsylvania,29634,620,920,300,10/13/2020 14:54,3/2/2022 20:59
2055,1961-06-11,Thomasville,Rhode Island,29634,430,430,0,10/13/2020 14:57,3/15/2021 10:30
2056,1999-01-27,Thomasville,South Carolina,29634,800,800,0,10/13/2020 15:10,10/13/2020 17:24
2057,1950-02-13,Seneca,South Carolina,29672,110,700,590,10/13/2020 15:22,3/16/2022 18:39
2058,2001-03-03,Thomasville,South Dakota,29634,570,570,0,10/13/2020 15:22,4/8/2021 13:45
2059,1964-06-22,Thomasville,Tennessee,29634,740,740,0,10/13/2020 15:39,4/30/2021 18:16
2060,1986-11-02,Thomasville,Texas,29634,370,870,500,10/13/2020 15:50,11/30/2021 18:18
2061,1953-10-26,Naples,Florida,34113,570,620,50,10/13/2020 16:14,4/15/2022 18:21
2062,1993-04-14,Winston-Salem,North Carolina,27106,20,720,700,10/13/2020 16:15,8/7/2021 4:22
2063,2004-10-26,Thomasville,Utah,29634,400,400,0,10/13/2020 16:25,3/1/2021 18:01
2064,1984-10-27,Thomasville,Vermont,29634,2010,2010,0,10/13/2020 16:26,6/29/2022 17:24
2065,1969-10-08,Thomasville,Virginia,29634,1300,1300,0,10/13/2020 16:29,3/16/2022 18:56
2066,1969-01-01,Thomasville,Washington,29634,610,610,0,10/13/2020 16:39,5/3/2022 13:00
2067,1976-06-20,Thomasville,West Virginia,29634,650,650,0,10/13/2020 16:51,10/18/2020 12:06
2068,2002-03-02,Thomasville,Wisconsin,29634,1450,1450,0,10/13/2020 16:56,4/15/2022 16:34
2069,1976-04-06,Thomasville,Wyoming,29634,600,600,0,10/13/2020 16:59,10/14/2021 11:31
2070,1997-12-07,Thomasville,Alabama,29634,2960,2960,0,10/13/2020 17:16,4/16/2022 15:09
2071,1975-05-21,Winston-Salem,North Carolina,27106,5760,6260,500,10/13/2020 17:18,5/11/2022 21:44
2072,1982-05-21,Thomasville,Alaska,29634,980,980,0,10/13/2020 17:27,5/19/2022 7:30
2073,1977-06-20,Thomasville,Arizona,29634,410,710,300,10/13/2020 17:52,5/2/2021 16:24
2074,1988-07-06,Thomasville,Arkansas,29634,3400,3400,0,10/13/2020 17:54,6/19/2022 13:26
2075,1998-07-06,Thomasville,California,29634,700,700,0,10/13/2020 17:54,
2076,1999-04-03,Thomasville,Colorado,29634,880,880,0,10/13/2020 17:56,5/2/2021 23:47
2077,1950-09-12,Thomasville,Connecticut,29634,1360,2360,1000,10/13/2020 18:06,4/19/2022 19:14
2078,1969-05-13,Thomasville,Delaware,29634,610,610,0,10/13/2020 18:08,5/2/2022 2:12
2079,1996-05-10,Thomasville,District of Columbia,29634,600,600,0,10/13/2020 18:26,2/19/2022 13:15
2080,1967-12-14,Thomasville,Florida,29634,1930,1930,0,10/13/2020 18:50,6/25/2022 23:10
2081,1956-10-14,Thomasville,Georgia,29634,900,900,0,10/13/2020 18:50,2/11/2022 20:51
2082,2002-10-23,Thomasville,Hawaii,29634,870,1170,300,10/13/2020 18:55,3/26/2022 11:29
2083,1964-08-08,Thomasville,Idaho,29634,1940,1940,0,10/13/2020 20:01,5/11/2022 14:03
2084,1961-09-18,Thomasville,Illinois,29634,400,400,0,10/13/2020 20:04,1/12/2022 14:21
2085,1974-06-13,Fairfield,Connecticut,6825,1070,1570,500,10/13/2020 20:06,4/27/2022 15:11
2086,1974-08-11,Thomasville,Indiana,29634,100,400,300,10/13/2020 20:08,3/26/2022 18:56
2087,1965-08-17,Thomasville,Iowa,29634,2070,2370,300,10/13/2020 20:13,4/18/2022 18:03
2088,1994-09-27,Thomasville,Kansas,29634,145,645,500,10/13/2020 20:27,4/23/2022 22:49
2089,1996-05-26,Thomasville,Kentucky,29634,400,400,0,10/13/2020 20:32,10/16/2020 15:35
2090,1972-11-11,Thomasville,Louisiana,29634,1010,1010,0,10/13/2020 20:37,1/18/2022 15:28
2091,1985-11-25,Thomasville,Maine,29634,400,400,0,10/13/2020 20:37,3/2/2022 22:56
2092,1968-06-16,Thomasville,Maryland,29634,770,770,0,10/13/2020 20:39,5/16/2022 9:49
2093,2004-09-18,Thomasville,Massachusetts,29634,2065,2365,300,10/13/2020 20:40,2/27/2022 12:12
2094,1958-06-01,Thomasville,Michigan,29634,760,760,0,10/13/2020 20:46,5/8/2021 13:14
2095,2005-05-09,Thomasville,Minnesota,29634,3190,3490,300,10/13/2020 20:48,5/11/2022 13:01
2096,1951-08-05,Thomasville,Mississippi,29634,400,400,0,10/13/2020 20:49,2/12/2022 13:59
2097,1951-02-02,Thomasville,Missouri,29634,800,800,0,10/13/2020 20:51,
2098,1964-09-07,Thomasville,Montana,29634,710,1210,500,10/13/2020 20:54,4/15/2022 20:00
2099,1972-05-01,Thomasville,Nebraska,29634,620,620,0,10/13/2020 21:03,5/11/2022 19:35
2100,1982-07-05,Thomasville,Nevada,29634,120,420,300,10/13/2020 21:08,4/30/2022 21:39
2101,1961-02-13,Thomasville,New Hampshire,29634,2275,2275,0,10/13/2020 21:10,4/20/2022 2:07
2102,1986-08-20,Thomasville,New Jersey,29634,500,500,0,10/13/2020 21:20,11/13/2021 22:55
2103,1964-03-18,Atlanta ,Georgia,30319,120,670,550,10/13/2020 21:30,12/1/2021 10:44
2104,2001-05-10,Thomasville,New Mexico,29634,700,700,0,10/13/2020 21:31,1/25/2022 19:31
2105,1952-10-14,Thomasville,New York,29634,430,730,300,10/13/2020 21:48,3/12/2021 18:47
2106,1979-04-03,Thomasville,North Carolina,29634,1270,1270,0,10/13/2020 21:54,1/10/2022 19:35
2107,1995-06-05,Wellesley,Massachusetts,2481,440,750,310,10/13/2020 22:06,10/14/2020 21:36
2108,1985-02-13,Thomasville,North Dakota,29634,400,700,300,10/13/2020 22:07,10/4/2021 12:58
2109,1968-03-11,Thomasville,Ohio,29634,725,725,0,10/13/2020 22:08,10/13/2020 22:33
2110,1999-05-01,Thomasville,Oklahoma,29634,630,630,0,10/13/2020 22:10,5/11/2022 18:16
2111,1992-07-09,Thomasville,Oregon,29634,730,730,0,10/13/2020 22:20,4/30/2021 18:10
2112,1964-06-09,Thomasville,Pennsylvania,29634,1150,1150,0,10/13/2020 22:21,3/25/2022 18:11
2113,1969-10-19,Thomasville,Rhode Island,29634,2235,2235,0,10/13/2020 22:28,6/17/2022 12:48
2114,1968-03-26,Thomasville,South Carolina,29634,300,600,300,10/13/2020 22:35,11/13/2021 19:07
2115,1999-08-24,Thomasville,South Dakota,29634,800,800,0,10/13/2020 22:40,6/27/2021 12:54
2116,1994-01-07,Thomasville,Tennessee,29634,1940,1940,0,10/13/2020 23:03,5/11/2022 17:16
2117,1970-01-09,Thomasville,Texas,29634,550,550,0,10/13/2020 23:15,2/17/2022 13:06
2118,1952-10-18,Thomasville,Utah,29634,100,500,400,10/13/2020 23:15,3/2/2022 19:46
2119,1973-05-08,Thomasville,Vermont,29634,950,950,0,10/13/2020 23:21,3/5/2022 14:32
2120,1984-09-28,Thomasville,Virginia,29634,2210,2210,0,10/13/2020 23:23,4/15/2022 19:22
2121,1980-09-27,Thomasville,Washington,29634,2695,2695,0,10/13/2020 23:26,1/22/2022 20:15
2122,1954-10-14,Thomasville,West Virginia,29634,250,550,300,10/13/2020 23:28,1/20/2022 13:48
2123,1974-12-21,Thomasville,Wisconsin,29634,1010,1010,0,10/13/2020 23:36,1/15/2022 21:15
2124,1994-05-11,Thomasville,Wyoming,29634,610,610,0,10/13/2020 23:40,4/15/2022 18:51
2125,1958-04-02,Thomasville,Alabama,29634,910,910,0,10/13/2020 23:41,4/8/2022 11:27
2126,1958-12-05,Thomasville,Alaska,29634,1010,1010,0,10/13/2020 23:51,4/16/2022 17:03
2127,1969-03-14,Thomasville,Arizona,29634,1050,1050,0,10/14/2020 0:08,2/26/2022 19:15
2128,1987-10-15,Thomasville,Arkansas,29634,450,450,0,10/14/2020 0:10,1/20/2022 13:55
2129,1972-10-28,Thomasville,California,29634,410,410,0,10/14/2020 0:24,6/5/2022 22:03
2130,2001-09-27,West Chester,Pennsylvania,19382,0,700,700,10/14/2020 0:26,3/17/2022 10:05
2131,1990-06-16,Thomasville,Colorado,29634,410,410,0,10/14/2020 8:35,10/14/2020 11:55
2132,1974-08-08,Thomasville,Connecticut,29634,775,775,0,10/14/2020 10:06,1/7/2022 17:14
2133,1989-02-16,Thomasville,Delaware,29634,500,500,0,10/14/2020 10:09,3/19/2022 10:55
2134,1984-12-08,Thomasville,District of Columbia,29634,1930,1930,0,10/14/2020 10:38,5/11/2022 18:43
2135,1966-11-12,Thomasville,Florida,29634,850,850,0,10/14/2020 11:13,2/15/2022 17:35
2136,1985-04-06,Thomasville,Georgia,29634,960,1460,500,10/14/2020 12:02,3/14/2022 12:26
2137,1996-05-25,Thomasville,Hawaii,29634,700,700,0,10/14/2020 12:14,
2138,1953-10-28,Thomasville,Idaho,29634,400,400,0,10/14/2020 12:16,2/22/2022 11:17
2139,1985-01-16,Thomasville,Illinois,29634,710,710,0,10/14/2020 12:29,5/1/2021 13:11
2140,1963-10-27,Chester Springs ,Pennsylvania,19425,500,800,300,10/14/2020 13:23,1/11/2022 19:14
2141,1999-08-26,Thomasville,Indiana,29634,710,710,0,10/14/2020 14:21,3/14/2022 9:00
2142,1986-05-14,Thomasville,Iowa,29634,1140,1140,0,10/14/2020 14:37,5/21/2021 13:40
2143,1963-08-16,Thomasville,Kansas,29634,700,700,0,10/14/2020 14:38,2/26/2021 10:39
2144,1970-10-28,Thomasville,Kentucky,29634,870,870,0,10/14/2020 16:02,10/17/2021 20:11
2145,2000-03-21,Thomasville,Louisiana,29634,450,450,0,10/14/2020 16:27,12/13/2021 9:21
2146,1994-04-05,Thomasville,Maine,29634,740,740,0,10/14/2020 16:42,5/2/2021 15:11
2147,1978-08-26,Thomasville,Maryland,29634,1460,1460,0,10/14/2020 18:32,1/20/2022 17:55
2148,1971-11-12,Thomasville,Massachusetts,29634,400,400,0,10/14/2020 22:33,
2149,1994-05-20,Winston-Salem,North Carolina,27106,470,720,250,10/14/2020 22:45,4/24/2021 20:04
2150,1980-02-10,Thomasville,Michigan,29634,2500,2500,0,10/15/2020 11:37,6/30/2022 14:03
2151,1970-09-11,Thomasville,Minnesota,29634,1470,1970,500,10/15/2020 14:25,1/22/2022 18:54
2152,1952-10-20,Thomasville,Mississippi,29634,700,700,0,10/15/2020 15:38,11/30/2021 11:48
2153,1966-01-15,Thomasville,Missouri,29634,700,700,0,10/15/2020 15:45,
2154,1990-01-27,Thomasville,Montana,29634,850,850,0,10/15/2020 16:05,
2155,1999-07-28,Thomasville,Nebraska,29634,900,900,0,10/15/2020 16:58,11/30/2021 20:36
2156,1969-04-27,Thomasville,Nevada,29634,600,600,0,10/15/2020 21:15,
2157,1963-08-02,Thomasville,New Hampshire,29634,310,810,500,10/16/2020 10:12,4/16/2022 16:16
2158,2000-11-24,Thomasville,New Jersey,29634,8425,8725,300,10/16/2020 11:16,7/1/2022 6:11
2159,1970-06-28,Thomasville,New Mexico,29634,3515,4015,500,10/16/2020 11:16,2/26/2022 18:32
2160,2002-01-18,Thomasville,New York,29634,800,1300,500,10/16/2020 11:54,3/8/2022 13:10
2161,2001-01-12,Thomasville,North Carolina,29634,3195,3495,300,10/16/2020 12:05,3/27/2022 12:11
2162,2005-08-11,Thomasville,North Dakota,29634,570,1070,500,10/16/2020 12:10,5/8/2022 13:56
2163,1990-10-06,Thomasville,Ohio,29634,180,680,500,10/16/2020 12:10,5/8/2022 17:43
2164,2000-12-06,Thomasville,Oklahoma,29634,620,620,0,10/16/2020 13:12,5/26/2022 20:06
2165,2003-12-26,Lafayette ,California,94549,0,400,400,10/16/2020 14:45,12/17/2020 2:09
2166,1969-07-10,Thomasville,Oregon,29634,1860,1860,0,10/16/2020 15:50,3/17/2022 12:02
2167,1971-05-10,Thomasville,Pennsylvania,29634,830,830,0,10/16/2020 16:35,11/27/2021 21:23
2168,1966-02-01,Thomasville,Rhode Island,29634,1220,1220,0,10/16/2020 18:46,1/12/2022 20:34
2169,2002-07-31,Thomasville,South Carolina,29634,1940,1940,0,10/16/2020 19:37,2/25/2022 10:29
2170,1974-03-20,Thomasville,South Dakota,29634,860,860,0,10/16/2020 20:31,6/25/2022 3:51
2171,2001-02-24,Thomasville,Tennessee,29634,2330,2630,300,10/16/2020 20:46,6/14/2022 17:00
2172,1970-06-19,Thomasville,Texas,29634,1620,2420,800,10/16/2020 21:00,12/4/2021 21:24
2173,1996-08-15,Thomasville,Utah,29634,1100,1100,0,10/17/2020 0:24,2/26/2022 19:15
2174,1960-03-26,Thomasville,Vermont,29634,1750,1750,0,10/17/2020 10:48,2/28/2022 9:00
2175,1965-05-27,Thomasville,Virginia,29634,1550,1550,0,10/17/2020 11:37,5/6/2022 18:23
2176,1984-03-28,Newtown Square,Pennsylvania,19073,405,430,25,10/17/2020 13:10,4/30/2021 14:18
2177,1969-10-10,Thomasville,Washington,29634,650,650,0,10/17/2020 13:50,10/18/2020 18:09
2178,2002-01-20,Thomasville,West Virginia,29634,2400,2900,500,10/17/2020 15:45,4/9/2022 16:31
2179,1978-01-11,Thomasville,Wisconsin,29634,1910,1910,0,10/17/2020 16:47,5/3/2022 17:40
2180,2001-02-21,Thomasville,Wyoming,29634,2960,2960,0,10/17/2020 20:09,4/10/2022 20:14
2181,1988-04-09,Thomasville,Alabama,29634,3370,3370,0,10/17/2020 20:58,4/9/2022 14:10
2182,1982-06-01,Thomasville,Alaska,29634,700,700,0,10/17/2020 21:18,9/18/2021 14:08
2183,1965-12-26,Thomasville,Arizona,29634,2280,2780,500,10/18/2020 1:01,4/10/2022 16:22
2184,2000-12-31,Thomasville,Arkansas,29634,2915,2915,0,10/18/2020 10:17,12/28/2021 19:08
2185,1969-01-19,Thomasville,California,29634,2110,2110,0,10/18/2020 10:47,6/30/2022 13:13
2186,1960-09-15,Thomasville,Colorado,29634,700,700,0,10/18/2020 10:59,1/22/2022 18:20
2187,1988-09-01,Thomasville,Connecticut,29634,4050,4050,0,10/18/2020 12:19,2/12/2022 14:11
2188,1981-12-02,Thomasville,Delaware,29634,410,410,0,10/18/2020 12:41,5/10/2022 4:01
2189,1951-10-20,Thomasville,District of Columbia,29634,1820,1820,0,10/18/2020 12:42,4/23/2022 21:16
2190,1979-09-27,Thomasville,Florida,29634,1070,1070,0,10/18/2020 13:03,4/9/2022 14:10
2191,2002-07-11,Thomasville,Georgia,29634,2260,2260,0,10/18/2020 13:04,3/25/2022 18:49
2192,1995-02-27,Thomasville,Hawaii,29634,3915,4215,300,10/18/2020 13:04,3/14/2022 9:08
2193,1976-01-14,Thomasville,Idaho,29634,2050,2050,0,10/18/2020 13:16,5/11/2022 19:40
2194,2001-07-11,Thomasville,Illinois,29634,870,870,0,10/18/2020 14:12,11/17/2021 14:05
2195,1968-01-02,Thomasville,Indiana,29634,310,810,500,10/18/2020 15:01,5/27/2022 5:06
2196,1992-12-19,Thomasville,Iowa,29634,1000,1000,0,10/18/2020 15:50,10/21/2020 0:12
2197,1988-05-02,Thomasville,Kansas,29634,700,700,0,10/18/2020 15:59,10/18/2020 16:00
2198,1959-11-01,Thomasville,Kentucky,29634,770,770,0,10/18/2020 16:33,3/15/2022 23:15
2199,1988-12-24,Thomasville,Louisiana,29634,700,700,0,10/18/2020 17:07,10/21/2020 11:04
2200,2002-04-23,Thomasville,Maine,29634,510,510,0,10/18/2020 17:14,4/17/2022 12:20
2201,1988-06-16,Thomasville,Maryland,29634,2510,2510,0,10/18/2020 18:20,3/16/2022 19:59
2202,1996-05-17,Thomasville,Massachusetts,29634,2710,3410,700,10/18/2020 18:30,3/17/2022 9:56
2203,1981-06-05,Thomasville,Michigan,29634,520,520,0,10/18/2020 19:04,4/16/2022 15:36
2204,1970-04-26,Thomasville,Minnesota,29634,850,850,0,10/18/2020 19:05,3/21/2022 10:21
2205,2002-04-15,Thomasville,Mississippi,29634,550,550,0,10/18/2020 19:06,3/5/2022 14:50
2206,2001-03-27,Thomasville,Missouri,29634,800,800,0,10/18/2020 19:13,2/26/2022 19:26
2207,1990-04-11,Thomasville,Montana,29634,160,660,500,10/18/2020 19:33,4/8/2022 11:24
2208,1951-11-06,Thomasville,Nebraska,29634,3370,3370,0,10/18/2020 19:36,3/17/2022 13:46
2209,1958-02-14,Thomasville,Nevada,29634,940,940,0,10/18/2020 20:09,2/10/2022 18:07
2210,1956-12-17,Thomasville,New Hampshire,29634,1540,1540,0,10/18/2020 20:48,1/10/2022 3:15
2211,1955-03-11,Thomasville,New Jersey,29634,950,950,0,10/18/2020 22:43,3/25/2022 10:07
2212,1998-07-22,Thomasville,New Mexico,29634,90,790,700,10/18/2020 22:57,5/2/2021 15:23
2213,2005-10-16,Thomasville,New York,29634,700,700,0,10/18/2020 22:58,10/18/2020 22:58
2214,1989-04-16,Winston-Salem,North Carolina,27106,630,700,70,10/18/2020 23:02,10/21/2020 20:35
2215,1975-04-18,Thomasville,North Carolina,29634,600,600,0,10/18/2020 23:04,3/25/2022 10:08
2216,1965-10-11,Thomasville,North Dakota,29634,700,700,0,10/18/2020 23:05,
2217,1953-07-20,Thomasville,Ohio,29634,410,410,0,10/18/2020 23:05,9/6/2021 11:14
2218,2002-12-01,Thomasville,Oklahoma,29634,1735,1735,0,10/18/2020 23:22,2/19/2022 12:24
2219,1959-12-16,Thomasville,Oregon,29634,1850,1850,0,10/19/2020 8:33,1/19/2022 18:23
2220,1997-03-23,Thomasville,Pennsylvania,29634,1320,3320,2000,10/19/2020 8:49,6/18/2022 20:14
2221,1983-07-01,Thomasville,Rhode Island,29634,1020,1020,0,10/19/2020 8:58,5/6/2022 13:49
2222,1981-02-23,Thomasville,South Carolina,29634,700,700,0,10/19/2020 9:03,10/20/2020 9:14
2223,1999-11-24,Thomasville,South Dakota,29634,11140,11140,0,10/19/2020 9:06,3/20/2022 21:17
2224,1977-08-01,Thomasville,Tennessee,29634,1370,1370,0,10/19/2020 9:12,5/15/2021 9:59
2225,1975-08-18,Thomasville,Texas,29634,880,880,0,10/19/2020 9:18,5/8/2021 10:56
2226,1953-04-13,Thomasville,Utah,29634,700,700,0,10/19/2020 9:19,10/21/2020 11:00
2227,1986-07-11,Thomasville,Vermont,29634,730,730,0,10/19/2020 9:21,4/22/2022 10:39
2228,1986-08-08,Thomasville,Virginia,29634,700,700,0,10/19/2020 9:28,1/13/2022 19:07
2229,1990-09-12,Thomasville,Washington,29634,700,700,0,10/19/2020 9:39,1/5/2022 21:12
2230,1951-07-04,Thomasville,West Virginia,29634,1130,1130,0,10/19/2020 9:47,11/13/2021 20:07
2231,2001-12-19,Thomasville,Wisconsin,29634,460,760,300,10/19/2020 9:50,5/9/2021 10:38
2232,1974-10-04,Thomasville,Wyoming,29634,750,750,0,10/19/2020 9:51,3/31/2022 2:31
2233,1987-05-16,Thomasville,Alabama,29634,700,700,0,10/19/2020 9:52,
2234,2002-07-19,Thomasville,Alaska,29634,1250,1750,500,10/19/2020 9:53,5/10/2022 18:00
2235,1999-03-06,Thomasville,Arizona,29634,1080,1080,0,10/19/2020 10:00,5/15/2021 23:55
2236,1962-09-12,Thomasville,Arkansas,29634,700,700,0,10/19/2020 10:09,10/19/2020 10:12
2237,1966-09-01,Thomasville,California,29634,1510,1510,0,10/19/2020 10:11,11/9/2021 9:15
2238,1950-06-22,Thomasville,Colorado,29634,700,700,0,10/19/2020 10:12,10/26/2020 16:28
2239,1982-04-19,Thomasville,Connecticut,29634,550,550,0,10/19/2020 10:15,3/14/2022 10:02
2240,1998-04-18,Thomasville,Delaware,29634,700,700,0,10/19/2020 10:16,
2241,1953-10-24,Thomasville,District of Columbia,29634,1520,1820,300,10/19/2020 10:17,3/16/2022 19:02
2242,1988-01-06,Thomasville,Florida,29634,700,700,0,10/19/2020 10:22,
2243,1957-07-03,Thomasville,Georgia,29634,700,700,0,10/19/2020 10:28,10/19/2020 16:17
2244,1996-07-12,Thomasville,Hawaii,29634,400,400,0,10/19/2020 10:38,1/24/2022 15:28
2245,1967-11-01,Thomasville,Idaho,29634,710,710,0,10/19/2020 10:41,5/2/2021 19:34
2246,1955-03-15,Thomasville,Illinois,29634,980,980,0,10/19/2020 10:48,4/29/2021 13:17
2247,2004-11-05,Thomasville,Indiana,29634,700,700,0,10/19/2020 10:57,
2248,1968-09-23,Thomasville,Iowa,29634,700,700,0,10/19/2020 10:58,
2249,1982-02-19,Thomasville,Kansas,29634,815,815,0,10/19/2020 10:59,5/13/2021 13:28
2250,1997-05-07,Thomasville,Kentucky,29634,700,700,0,10/19/2020 11:21,10/20/2020 23:28
2251,2002-11-27,Thomasville,Louisiana,29634,600,600,0,10/19/2020 11:23,1/12/2022 20:25
2252,2005-03-04,Thomasville,Maine,29634,600,600,0,10/19/2020 11:31,3/29/2022 9:18
2253,2001-10-18,Thomasville,Maryland,29634,2190,2190,0,10/19/2020 11:46,3/25/2022 17:39
2254,1960-10-19,Thomasville,Massachusetts,29634,1110,1110,0,10/19/2020 11:46,3/18/2022 18:41
2255,1999-05-25,Thomasville,Michigan,29634,970,970,0,10/19/2020 11:48,1/31/2022 13:30
2256,2001-11-24,Thomasville,Minnesota,29634,550,550,0,10/19/2020 11:51,3/22/2022 14:14
2257,1999-04-09,Thomasville,Mississippi,29634,90,1890,1800,10/19/2020 11:53,5/8/2021 15:58
2258,1998-08-20,Winston-Salem,North Carolina,27106,1130,1130,0,10/19/2020 11:55,1/13/2022 15:19
2259,2001-07-04,Thomasville,Missouri,29634,710,710,0,10/19/2020 11:55,
2260,1963-11-06,Thomasville,Montana,29634,280,780,500,10/19/2020 12:00,3/26/2022 17:41
2261,1993-04-11,Thomasville,Nebraska,29634,1280,1280,0,10/19/2020 12:01,4/29/2022 16:57
2262,1994-10-06,Thomasville,Nevada,29634,1120,1620,500,10/19/2020 12:01,6/7/2022 17:55
2263,1959-09-26,Thomasville,New Hampshire,29634,400,400,0,10/19/2020 12:04,10/30/2021 14:49
2264,1999-04-13,Thomasville,New Jersey,29634,810,810,0,10/19/2020 12:05,10/19/2020 12:09
2265,1966-06-28,Thomasville,New Mexico,29634,430,730,300,10/19/2020 12:06,5/2/2021 20:09
2266,2000-05-15,Thomasville,New York,29634,650,650,0,10/19/2020 12:06,1/11/2022 0:20
2267,1984-04-13,Thomasville,North Carolina,29634,700,700,0,10/19/2020 12:08,
2268,1998-06-01,Thomasville,North Dakota,29634,450,450,0,10/19/2020 12:09,2/11/2022 16:05
2269,2005-01-15,Thomasville,Ohio,29634,700,700,0,10/19/2020 12:11,10/12/2021 15:55
2270,1987-04-01,Thomasville,Oklahoma,29634,400,400,0,10/19/2020 12:13,2/20/2022 14:50
2271,1980-03-11,Thomasville,Oregon,29634,110,410,300,10/19/2020 12:18,2/23/2022 19:06
2272,1980-08-01,Thomasville,Pennsylvania,29634,1830,1830,0,10/19/2020 12:21,4/27/2022 9:04
2273,1986-05-20,Thomasville,Rhode Island,29634,240,740,500,10/19/2020 12:24,5/9/2021 17:18
2274,1975-04-23,Thomasville,South Carolina,29634,2600,2600,0,10/19/2020 12:25,6/26/2022 16:39
2275,1997-03-09,Thomasville,South Dakota,29634,270,770,500,10/19/2020 12:26,5/12/2021 13:38
2276,1977-10-01,Thomasville,Tennessee,29634,700,700,0,10/19/2020 12:27,
2277,1994-03-12,Thomasville,Texas,29634,1600,1600,0,10/19/2020 12:29,4/2/2022 16:53
2278,1965-06-16,Thomasville,Utah,29634,220,720,500,10/19/2020 12:33,8/21/2021 12:59
2279,1974-08-10,Thomasville,Vermont,29634,700,700,0,10/19/2020 12:34,10/19/2020 19:13
2280,1995-05-12,Thomasville,Virginia,29634,860,860,0,10/19/2020 12:35,4/12/2022 20:48
2281,1955-02-03,Thomasville,Washington,29634,770,770,0,10/19/2020 12:36,8/22/2021 1:51
2282,2001-01-18,Thomasville,West Virginia,29634,700,700,0,10/19/2020 12:37,
2283,1976-09-26,Thomasville,Wisconsin,29634,710,710,0,10/19/2020 12:39,4/16/2022 17:01
2284,2002-10-18,Thomasville,Wyoming,29634,1100,1100,0,10/19/2020 12:42,2/26/2022 13:45
2285,1971-07-21,Thomasville,Alabama,29634,700,700,0,10/19/2020 12:48,10/21/2020 11:59
2286,1956-12-12,Thomasville,Alaska,29634,700,700,0,10/19/2020 12:49,10/19/2020 18:39
2287,1983-08-28,Thomasville,Arizona,29634,400,400,0,10/19/2020 12:52,
2288,2004-05-22,Thomasville,Arkansas,29634,450,450,0,10/19/2020 12:57,12/12/2021 20:37
2289,1999-03-11,Thomasville,California,29634,1000,1000,0,10/19/2020 13:05,3/18/2022 16:04
2290,1952-09-02,Thomasville,Colorado,29634,710,710,0,10/19/2020 13:14,5/3/2021 15:55
2291,1963-02-17,Thomasville,Connecticut,29634,790,790,0,10/19/2020 13:18,5/8/2021 12:22
2292,1967-03-22,Thomasville,Delaware,29634,660,660,0,10/19/2020 13:19,6/11/2022 23:19
2293,1990-02-15,Thomasville,District of Columbia,29634,930,930,0,10/19/2020 13:23,5/8/2021 13:30
2294,1965-12-28,Thomasville,Florida,29634,700,700,0,10/19/2020 13:29,
2295,1959-04-25,Thomasville,Georgia,29634,1500,1900,400,10/19/2020 13:30,3/26/2022 16:00
2296,1976-02-04,Thomasville,Hawaii,29634,700,700,0,10/19/2020 13:34,
2297,1959-01-26,Thomasville,Idaho,29634,700,700,0,10/19/2020 13:43,10/19/2020 13:50
2298,1999-06-18,Thomasville,Illinois,29634,830,830,0,10/19/2020 13:47,6/6/2021 11:56
2299,1985-07-23,Thomasville,Indiana,29634,700,700,0,10/19/2020 13:54,
2300,1970-06-17,Thomasville,Iowa,29634,700,700,0,10/19/2020 14:11,10/19/2020 14:27
2301,1981-03-23,Thomasville,Kansas,29634,700,700,0,10/19/2020 14:15,10/26/2020 23:26
2302,2001-10-27,Thomasville,Kentucky,29634,700,700,0,10/19/2020 14:27,
2303,1991-04-05,Thomasville,Louisiana,29634,2440,2440,0,10/19/2020 14:33,4/21/2022 0:36
2304,2002-05-17,Thomasville,Maine,29634,160,660,500,10/19/2020 14:40,4/11/2022 12:10
2305,1951-05-27,Thomasville,Maryland,29634,700,700,0,10/19/2020 14:49,10/21/2020 9:53
2306,1998-07-17,Thomasville,Massachusetts,29634,800,800,0,10/19/2020 15:07,1/12/2022 17:50
2307,1960-04-11,Winston-Salem,North Carolina,27106,800,900,100,10/19/2020 15:16,5/8/2021 19:05
2308,1997-12-23,Thomasville,Michigan,29634,400,900,500,10/19/2020 15:21,3/13/2022 15:22
2309,1996-04-18,Thomasville,Minnesota,29634,500,500,0,10/19/2020 15:36,3/2/2022 20:10
2310,1973-11-06,Thomasville,Mississippi,29634,710,710,0,10/19/2020 15:54,4/26/2021 12:42
2311,1963-03-28,Thomasville,Missouri,29634,700,700,0,10/19/2020 16:11,10/21/2020 11:12
2312,1962-12-06,Thomasville,Montana,29634,600,600,0,10/19/2020 16:18,11/13/2021 16:49
2313,1980-03-01,Thomasville,Nebraska,29634,700,700,0,10/19/2020 16:29,10/20/2020 20:03
2314,1982-10-05,Thomasville,Nevada,29634,700,700,0,10/19/2020 16:33,
2315,1958-03-04,Thomasville,New Hampshire,29634,700,700,0,10/19/2020 16:40,10/19/2020 16:44
2316,1998-03-13,Thomasville,New Jersey,29634,790,790,0,10/19/2020 16:43,4/29/2021 10:14
2317,2000-10-07,Thomasville,New Mexico,29634,330,1130,800,10/19/2020 16:46,5/8/2021 14:40
2318,1995-07-04,Thomasville,New York,29634,600,600,0,10/19/2020 16:53,3/2/2022 20:39
2319,1978-06-27,Thomasville,North Carolina,29634,8740,8740,0,10/19/2020 16:56,4/29/2022 2:16
2320,1966-11-19,Thomasville,North Dakota,29634,700,700,0,10/19/2020 16:57,10/19/2020 16:58
2321,1961-12-10,Thomasville,Ohio,29634,400,400,0,10/19/2020 17:00,
2322,1968-02-13,Thomasville,Oklahoma,29634,400,400,0,10/19/2020 17:06,12/28/2021 19:00
2323,1986-02-25,Thomasville,Oregon,29634,850,850,0,10/19/2020 17:07,4/6/2022 9:51
2324,1972-02-09,Thomasville,Pennsylvania,29634,1075,1075,0,10/19/2020 17:07,3/2/2022 19:52
2325,1960-12-26,Thomasville,Rhode Island,29634,700,700,0,10/19/2020 17:08,
2326,1963-08-01,Thomasville,South Carolina,29634,800,800,0,10/19/2020 17:17,2/7/2022 12:45
2327,1993-04-20,Thomasville,South Dakota,29634,700,700,0,10/19/2020 17:20,10/21/2020 11:05
2328,1984-04-24,Thomasville,Tennessee,29634,10,810,800,10/19/2020 17:23,3/29/2021 18:06
2329,1997-04-12,Thomasville,Texas,29634,4160,4160,0,10/19/2020 17:29,5/26/2022 20:46
2330,1985-11-13,Thomasville,Utah,29634,700,700,0,10/19/2020 17:48,12/13/2020 15:52
2331,1955-08-22,Thomasville,Vermont,29634,400,400,0,10/19/2020 17:59,10/19/2020 18:00
2332,1968-10-05,Thomasville,Virginia,29634,1450,1450,0,10/19/2020 18:24,3/17/2022 12:01
2333,1964-10-13,Thomasville,Washington,29634,910,1210,300,10/19/2020 18:53,4/6/2022 10:09
2334,2002-07-25,Thomasville,West Virginia,29634,5940,5940,0,10/19/2020 18:53,6/30/2022 20:53
2335,1993-03-21,Thomasville,Wisconsin,29634,1635,1635,0,10/19/2020 18:53,1/21/2022 3:59
2336,1994-03-22,Thomasville,Wyoming,29634,770,870,100,10/19/2020 19:04,4/29/2021 13:21
2337,1956-06-07,Thomasville,Alabama,29634,700,700,0,10/19/2020 19:05,10/19/2020 19:13
2338,1977-03-23,Thomasville,Alaska,29634,480,480,0,10/19/2020 19:12,1/22/2022 12:10
2339,1957-01-27,Thomasville,Arizona,29634,1260,1260,0,10/19/2020 19:12,5/5/2022 18:40
2340,1995-10-18,Thomasville,Arkansas,29634,970,970,0,10/19/2020 19:13,1/10/2022 13:34
2341,1952-01-07,Thomasville,California,29634,1300,1300,0,10/19/2020 19:18,2/19/2022 13:29
2342,1996-10-12,Thomasville,Colorado,29634,1790,2890,1100,10/19/2020 19:19,4/17/2022 18:43
2343,1954-04-05,Thomasville,Connecticut,29634,1040,1040,0,10/19/2020 19:21,4/18/2022 20:18
2344,1987-01-12,Thomasville,Delaware,29634,990,990,0,10/19/2020 19:23,4/15/2022 19:21
2345,1999-05-23,Thomasville,District of Columbia,29634,800,800,0,10/19/2020 19:23,3/7/2022 20:58
2346,1996-04-20,Thomasville,Florida,29634,1450,1450,0,10/19/2020 19:25,1/23/2022 18:14
2347,1976-06-26,Thomasville,Georgia,29634,760,760,0,10/19/2020 19:25,5/19/2021 8:48
2348,2001-03-13,Thomasville,Hawaii,29634,1090,1090,0,10/19/2020 19:27,5/5/2022 16:20
2349,1975-07-07,Thomasville,Idaho,29634,1060,1060,0,10/19/2020 19:38,2/25/2022 16:21
2350,1982-04-23,Thomasville,Illinois,29634,800,800,0,10/19/2020 19:49,12/12/2020 12:21
2351,1998-09-07,Thomasville,Indiana,29634,870,870,0,10/19/2020 19:53,5/23/2021 12:25
2352,1984-05-04,Thomasville,Iowa,29634,1130,1130,0,10/19/2020 19:56,5/16/2022 19:38
2353,1987-09-27,Thomasville,Kansas,29634,400,400,0,10/19/2020 19:58,10/24/2020 14:44
2354,1969-06-12,Thomasville,Kentucky,29634,1020,1020,0,10/19/2020 19:59,5/11/2022 13:11
2355,1970-06-15,Thomasville,Louisiana,29634,400,400,0,10/19/2020 20:00,10/19/2020 20:01
2356,1991-06-21,Thomasville,Maine,29634,350,850,500,10/19/2020 20:00,3/24/2022 19:35
2357,1952-01-19,Thomasville,Maryland,29634,2100,2100,0,10/19/2020 20:02,3/2/2022 21:33
2358,1961-09-12,Thomasville,Massachusetts,29634,1190,1190,0,10/19/2020 20:03,3/2/2022 21:14
2359,1984-09-20,Thomasville,Michigan,29634,1420,1420,0,10/19/2020 20:04,4/11/2022 0:23
2360,1998-01-04,Thomasville,Minnesota,29634,400,400,0,10/19/2020 20:05,
2361,1986-02-16,Thomasville,Mississippi,29634,620,620,0,10/19/2020 20:08,4/8/2022 12:44
2362,1959-12-08,Thomasville,Missouri,29634,760,760,0,10/19/2020 20:09,5/9/2021 21:50
2363,2003-06-14,Thomasville,Montana,29634,700,700,0,10/19/2020 20:11,10/19/2020 20:11
2364,1972-02-14,Thomasville,Nebraska,29634,1060,1060,0,10/19/2020 20:12,4/15/2022 14:15
2365,1954-08-24,Thomasville,Nevada,29634,1790,1790,0,10/19/2020 20:15,3/2/2022 20:51
2366,2002-02-18,Thomasville,New Hampshire,29634,380,880,500,10/19/2020 20:15,6/29/2022 14:35
2367,1962-03-23,Thomasville,New Jersey,29634,750,750,0,10/19/2020 20:26,10/23/2020 12:01
2368,2000-04-01,Thomasville,New Mexico,29634,700,700,0,10/19/2020 20:26,9/18/2021 17:00
2369,1952-02-13,Thomasville,New York,29634,700,700,0,10/19/2020 20:26,
2370,1992-09-27,Thomasville,North Carolina,29634,700,700,0,10/19/2020 20:26,
2371,1968-11-16,Thomasville,North Dakota,29634,710,710,0,10/19/2020 20:27,5/23/2022 21:21
2372,1969-06-03,Thomasville,Ohio,29634,700,700,0,10/19/2020 20:30,
2373,1998-12-10,Thomasville,Oklahoma,29634,3640,3640,0,10/19/2020 20:45,5/26/2022 20:07
2374,1973-10-07,Thomasville,Oregon,29634,820,820,0,10/19/2020 20:46,12/12/2020 18:13
2375,1991-03-13,Thomasville,Pennsylvania,29634,700,700,0,10/19/2020 20:46,
2376,1980-04-13,Thomasville,Rhode Island,29634,600,600,0,10/19/2020 20:46,2/2/2022 13:51
2377,1989-05-21,Thomasville,South Carolina,29634,770,770,0,10/19/2020 20:51,4/9/2022 11:31
2378,1962-03-22,Thomasville,South Dakota,29634,780,780,0,10/19/2020 21:06,5/2/2021 19:53
2379,1955-02-26,Thomasville,Tennessee,29634,700,700,0,10/19/2020 21:22,11/15/2020 14:52
2380,1978-07-24,Thomasville,Texas,29634,350,650,300,10/19/2020 21:35,2/26/2022 18:51
2381,1999-09-26,Thomasville,Utah,29634,630,630,0,10/19/2020 21:38,4/17/2022 8:46
2382,2000-07-13,Thomasville,Vermont,29634,1060,1560,500,10/19/2020 21:43,4/29/2022 0:03
2383,1992-07-11,Thomasville,Virginia,29634,3580,3580,0,10/19/2020 21:57,6/29/2022 17:31
2384,1980-04-24,Thomasville,Washington,29634,4190,4190,0,10/19/2020 21:58,5/11/2022 18:44
2385,1973-12-09,Thomasville,West Virginia,29634,1170,1170,0,10/19/2020 22:17,4/8/2022 19:41
2386,2001-07-17,Thomasville,Wisconsin,29634,710,710,0,10/19/2020 22:17,4/8/2022 19:41
2387,1955-12-22,Thomasville,Wyoming,29634,700,700,0,10/19/2020 22:19,
2388,1983-04-27,Thomasville,Alabama,29634,720,720,0,10/19/2020 22:24,4/29/2021 13:17
2389,2002-02-25,Thomasville,Alaska,29634,2015,2015,0,10/19/2020 22:25,4/12/2022 9:32
2390,1990-05-16,Thomasville,Arizona,29634,700,700,0,10/19/2020 22:29,
2391,1961-08-27,Anderson ,South Carolina,29621,1510,2070,560,10/19/2020 22:48,6/29/2022 10:04
2392,1987-06-18,Thomasville,Arkansas,29634,620,620,0,10/19/2020 22:52,5/3/2022 20:53
2393,1974-05-09,Thomasville,California,29634,600,600,0,10/19/2020 23:25,3/26/2022 2:29
2394,1977-02-14,Thomasville,Colorado,29634,1910,6030,4120,10/20/2020 0:46,4/22/2022 13:53
2395,1985-06-19,Thomasville,Connecticut,29634,820,820,0,10/20/2020 8:04,3/17/2022 12:20
2396,1958-06-14,Thomasville,Delaware,29634,700,700,0,10/20/2020 8:23,10/20/2020 8:24
2397,1991-12-11,Thomasville,District of Columbia,29634,700,700,0,10/20/2020 9:00,
2398,1990-03-28,Thomasville,Florida,29634,620,920,300,10/20/2020 9:07,1/12/2022 16:58
2399,1992-05-15,Thomasville,Georgia,29634,940,940,0,10/20/2020 9:43,5/22/2021 12:34
2400,1974-05-05,Thomasville,Hawaii,29634,410,910,500,10/20/2020 10:41,4/8/2022 21:53
2401,1996-04-12,Thomasville,Idaho,29634,810,810,0,10/20/2020 10:50,6/13/2022 8:49
2402,1964-04-18,Thomasville,Illinois,29634,700,700,0,10/20/2020 11:03,
2403,1967-05-27,Thomasville,Indiana,29634,670,1170,500,10/20/2020 11:04,6/30/2022 9:14
2404,1958-04-18,Thomasville,Iowa,29634,700,700,0,10/20/2020 11:06,
2405,1964-12-01,Thomasville,Kansas,29634,1650,1650,0,10/20/2020 11:07,3/28/2022 14:58
2406,2000-06-01,Thomasville,Kentucky,29634,1010,1010,0,10/20/2020 11:11,3/5/2022 14:40
2407,1977-03-12,Thomasville,Louisiana,29634,400,700,300,10/20/2020 11:24,5/31/2021 13:26
2408,2005-10-13,Winston-Salem,North Carolina,27106,700,700,0,10/20/2020 11:27,11/13/2020 14:11
2409,1998-04-17,Thomasville,Maine,29634,1250,1250,0,10/20/2020 11:28,3/25/2022 20:25
2410,1959-10-28,Thomasville,Maryland,29634,700,700,0,10/20/2020 11:32,1/7/2021 17:34
2411,1987-02-01,Thomasville,Massachusetts,29634,400,700,300,10/20/2020 11:36,3/5/2021 11:41
2412,1986-08-04,Thomasville,Michigan,29634,700,700,0,10/20/2020 11:38,
2413,1954-08-11,Thomasville,Minnesota,29634,700,700,0,10/20/2020 11:39,
2414,1956-04-26,Thomasville,Mississippi,29634,700,700,0,10/20/2020 11:43,10/20/2020 18:06
2415,1957-08-12,Thomasville,Missouri,29634,750,750,0,10/20/2020 11:47,9/15/2021 20:00
2416,1968-01-04,Thomasville,Montana,29634,700,700,0,10/20/2020 11:48,
2417,1982-05-24,Thomasville,Nebraska,29634,700,700,0,10/20/2020 11:50,10/21/2020 11:21
2418,1962-05-09,Thomasville,Nevada,29634,700,700,0,10/20/2020 11:57,
2419,1974-09-06,Thomasville,New Hampshire,29634,700,700,0,10/20/2020 11:58,2/1/2021 8:51
2420,1958-11-08,Thomasville,New Jersey,29634,2410,2410,0,10/20/2020 12:04,5/11/2022 19:07
2421,1986-02-23,Thomasville,New Mexico,29634,600,600,0,10/20/2020 12:09,11/27/2021 19:39
2422,1981-09-21,Thomasville,New York,29634,700,700,0,10/20/2020 12:18,3/14/2022 16:44
2423,1962-12-14,Thomasville,North Carolina,29634,700,700,0,10/20/2020 12:18,
2424,1974-09-24,Thomasville,North Dakota,29634,700,700,0,10/20/2020 12:20,
2425,1999-05-27,Thomasville,Ohio,29634,700,700,0,10/20/2020 12:31,10/20/2020 12:33
2426,1986-05-06,Winston-Salem,North Carolina,27106,500,700,200,10/20/2020 12:36,10/21/2020 14:52
2427,2000-12-07,Thomasville,Oklahoma,29634,600,600,0,10/20/2020 12:42,3/5/2022 9:25
2428,1960-04-15,Thomasville,Oregon,29634,600,600,0,10/20/2020 12:51,3/2/2022 20:49
2429,2004-09-10,Natick,Massachusetts,1760,1170,1420,250,10/20/2020 13:03,4/11/2022 17:32
2430,2001-04-11,Thomasville,Pennsylvania,29634,1410,1410,0,10/20/2020 13:04,4/16/2022 14:07
2431,1974-03-14,Thomasville,Rhode Island,29634,520,520,0,10/20/2020 13:11,4/8/2022 22:32
2432,2001-04-04,Thomasville,South Carolina,29634,310,610,300,10/20/2020 13:11,5/11/2022 14:01
2433,1978-09-23,Thomasville,South Dakota,29634,500,500,0,10/20/2020 13:13,2/27/2022 13:35
2434,1957-07-09,Thomasville,Tennessee,29634,750,750,0,10/20/2020 13:19,3/20/2022 12:42
2435,1967-01-16,Thomasville,Texas,29634,1930,1930,0,10/20/2020 13:19,3/2/2022 20:57
2436,1991-09-22,Thomasville,Utah,29634,510,810,300,10/20/2020 13:21,5/6/2022 19:13
2437,1980-10-28,Thomasville,Vermont,29634,500,500,0,10/20/2020 13:22,3/2/2022 17:31
2438,1968-05-06,Thomasville,Virginia,29634,1600,1600,0,10/20/2020 13:24,2/2/2022 19:23
2439,1951-05-25,Thomasville,Washington,29634,500,500,0,10/20/2020 13:28,3/1/2022 12:06
2440,1976-09-17,Thomasville,West Virginia,29634,1810,1810,0,10/20/2020 13:29,3/19/2022 12:09
2441,2001-04-24,Thomasville,Wisconsin,29634,1020,1020,0,10/20/2020 13:29,5/5/2022 18:40
2442,1950-09-19,Thomasville,Wyoming,29634,1060,1060,0,10/20/2020 13:34,5/6/2022 19:02
2443,1953-02-28,Thomasville,Alabama,29634,600,600,0,10/20/2020 13:37,
2444,1953-08-13,Thomasville,Alaska,29634,910,910,0,10/20/2020 13:40,12/1/2021 14:23
2445,2000-11-29,Thomasville,Arizona,29634,700,700,0,10/20/2020 13:42,3/3/2022 21:21
2446,1964-03-14,Thomasville,Arkansas,29634,810,810,0,10/20/2020 13:43,4/11/2022 14:13
2447,1956-05-08,Thomasville,California,29634,710,710,0,10/20/2020 13:51,1/22/2022 20:25
2448,1989-08-04,Thomasville,Colorado,29634,1540,1540,0,10/20/2020 13:54,5/14/2022 16:31
2449,1978-02-01,Thomasville,Connecticut,29634,1100,1100,0,10/20/2020 13:56,1/22/2022 20:35
2450,1999-02-23,Thomasville,Delaware,29634,1210,1210,0,10/20/2020 14:19,5/10/2022 18:00
2451,1952-01-26,Thomasville,District of Columbia,29634,700,700,0,10/20/2020 14:36,10/21/2020 13:07
2452,1997-10-17,Thomasville,Florida,29634,1530,1530,0,10/20/2020 14:47,4/16/2022 19:21
2453,1951-09-18,Thomasville,Georgia,29634,700,700,0,10/20/2020 14:48,3/2/2021 21:08
2454,1979-11-21,Thomasville,Hawaii,29634,700,700,0,10/20/2020 14:51,10/21/2020 13:11
2455,1970-07-07,Thomasville,Idaho,29634,500,500,0,10/20/2020 14:58,11/29/2021 19:01
2456,1996-10-02,Thomasville,Illinois,29634,700,700,0,10/20/2020 14:59,10/21/2020 14:36
2457,2000-12-04,Thomasville,Indiana,29634,2040,2040,0,10/20/2020 15:09,6/28/2022 9:53
2458,2000-01-01,Thomasville,Iowa,29634,100,600,500,10/20/2020 15:31,1/10/2022 9:52
2459,1950-06-05,Thomasville,Kansas,29634,700,700,0,10/20/2020 15:34,10/21/2020 18:01
2460,1979-11-02,Thomasville,Kentucky,29634,1240,1240,0,10/20/2020 15:39,5/25/2022 20:42
2461,1976-08-11,Thomasville,Louisiana,29634,700,700,0,10/20/2020 15:39,10/20/2020 18:35
2462,1971-10-23,Thomasville,Maine,29634,700,700,0,10/20/2020 15:53,
2463,2002-04-30,Thomasville,Maryland,29634,2750,2750,0,10/20/2020 16:01,5/17/2022 7:37
2464,1982-11-09,Winston-Salem,North Carolina,27109,1500,1800,300,10/20/2020 16:30,3/16/2022 16:29
2465,1956-06-17,Thomasville,Massachusetts,29634,700,700,0,10/20/2020 16:38,10/21/2020 13:05
2466,2005-09-05,Thomasville,Michigan,29634,700,700,0,10/20/2020 16:38,
2467,1994-05-19,Thomasville,Minnesota,29634,700,700,0,10/20/2020 16:40,11/13/2021 18:33
2468,1961-10-09,Thomasville,Mississippi,29634,700,700,0,10/20/2020 16:42,11/18/2021 16:03
2469,1982-02-02,Thomasville,Missouri,29634,700,700,0,10/20/2020 16:42,
2470,2005-07-22,Thomasville,Montana,29634,3085,3585,500,10/20/2020 16:46,5/3/2022 17:55
2471,1964-01-27,Thomasville,Nebraska,29634,700,700,0,10/20/2020 16:47,12/24/2021 12:49
2472,2002-10-26,Thomasville,Nevada,29634,1800,1800,0,10/20/2020 16:51,6/30/2022 20:42
2473,1950-03-23,Thomasville,New Hampshire,29634,2360,2360,0,10/20/2020 16:54,6/30/2022 7:59
2474,1978-08-14,Thomasville,New Jersey,29634,700,700,0,10/20/2020 16:59,
2475,1966-05-10,Thomasville,New Mexico,29634,210,510,300,10/20/2020 17:03,11/13/2021 19:15
2476,1991-04-06,Thomasville,New York,29634,710,710,0,10/20/2020 17:03,3/20/2021 11:30
2477,1989-12-04,Thomasville,North Carolina,29634,700,700,0,10/20/2020 17:03,
2478,2004-06-15,Thomasville,North Dakota,29634,2680,2680,0,10/20/2020 17:06,6/29/2022 13:31
2479,1983-11-20,Thomasville,Ohio,29634,710,710,0,10/20/2020 17:06,5/3/2022 17:48
2480,1997-03-12,Thomasville,Oklahoma,29634,1610,1610,0,10/20/2020 17:06,4/9/2022 13:36
2481,1957-12-18,Thomasville,Oregon,29634,550,550,0,10/20/2020 17:06,12/1/2021 10:27
2482,1963-08-18,Thomasville,Pennsylvania,29634,700,700,0,10/20/2020 17:14,
2483,1998-09-01,Thomasville,Rhode Island,29634,880,880,0,10/20/2020 17:17,11/12/2021 16:36
2484,2004-11-03,Thomasville,South Carolina,29634,700,700,0,10/20/2020 17:18,
2485,1965-06-14,Thomasville,South Dakota,29634,700,700,0,10/20/2020 17:21,2/26/2021 12:39
2486,1973-01-01,Thomasville,Tennessee,29634,700,700,0,10/20/2020 17:24,10/20/2020 17:30
2487,1972-07-06,Thomasville,Texas,29634,700,700,0,10/20/2020 17:29,2/24/2021 20:57
2488,1963-07-04,Thomasville,Utah,29634,700,700,0,10/20/2020 17:29,
2489,1961-09-15,Thomasville,Vermont,29634,3340,3340,0,10/20/2020 17:48,5/28/2022 23:38
2490,1981-12-17,Thomasville,Virginia,29634,700,700,0,10/20/2020 18:02,12/18/2020 18:10
2491,1961-06-14,Thomasville,Washington,29634,780,780,0,10/20/2020 18:19,2/17/2022 13:00
2492,1976-05-09,Thomasville,West Virginia,29634,400,400,0,10/20/2020 18:20,1/27/2022 11:00
2493,1995-05-14,Thomasville,Wisconsin,29634,700,700,0,10/20/2020 18:21,
2494,1992-01-13,Thomasville,Wyoming,29634,400,400,0,10/20/2020 18:33,
2495,1965-09-24,Thomasville,Alabama,29634,500,500,0,10/20/2020 18:34,3/15/2022 10:30
2496,1978-06-01,Thomasville,Alaska,29634,860,860,0,10/20/2020 18:34,4/30/2022 15:25
2497,1987-06-27,Thomasville,Arizona,29634,700,700,0,10/20/2020 18:36,
2498,1990-05-04,Thomasville,Arkansas,29634,700,700,0,10/20/2020 18:42,10/22/2020 10:31
2499,1980-09-19,Thomasville,California,29634,2680,4980,2300,10/20/2020 19:13,5/8/2022 13:11
2500,2004-02-07,Thomasville,Colorado,29634,700,700,0,10/20/2020 19:20,
2501,1987-04-02,Thomasville,Connecticut,29634,2360,2360,0,10/20/2020 19:23,4/19/2022 17:15
2502,1992-04-21,Thomasville,Delaware,29634,700,700,0,10/20/2020 19:23,
2503,1976-11-20,Thomasville,District of Columbia,29634,800,800,0,10/20/2020 19:28,9/18/2021 17:00
2504,2000-12-08,Winston-Salem ,North Carolina,27109,3125,3150,25,10/20/2020 20:06,3/28/2022 16:21
2505,1999-12-15,Thomasville,Florida,29634,700,700,0,10/20/2020 20:07,3/7/2021 21:47
2506,1993-08-13,Thomasville,Georgia,29634,3580,3580,0,10/20/2020 20:10,4/19/2022 18:26
2507,1972-04-28,Thomasville,Hawaii,29634,1410,1410,0,10/20/2020 20:19,4/8/2022 9:14
2508,1969-10-21,Thomasville,Idaho,29634,950,950,0,10/20/2020 20:20,3/25/2022 18:41
2509,1994-02-21,Thomasville,Illinois,29634,500,500,0,10/20/2020 20:22,3/25/2022 17:27
2510,1967-01-03,Thomasville,Indiana,29634,600,600,0,10/20/2020 20:31,3/2/2022 21:14
2511,1999-01-20,Thomasville,Iowa,29634,450,450,0,10/20/2020 20:32,1/20/2022 12:23
2512,1950-06-12,Thomasville,Kansas,29634,210,710,500,10/20/2020 20:45,5/10/2021 8:46
2513,1973-02-19,Thomasville,Kentucky,29634,610,610,0,10/20/2020 20:48,3/19/2022 16:20
2514,1963-10-08,Thomasville,Louisiana,29634,600,600,0,10/20/2020 20:54,1/10/2022 22:28
2515,1973-01-03,Thomasville,Maine,29634,510,510,0,10/20/2020 21:00,4/24/2022 22:37
2516,1980-08-06,Thomasville,Maryland,29634,1450,1450,0,10/20/2020 21:05,3/17/2022 14:24
2517,1981-11-21,Thomasville,Massachusetts,29634,450,450,0,10/20/2020 21:11,1/25/2022 2:04
2518,1960-10-05,Thomasville,Michigan,29634,700,700,0,10/20/2020 21:14,1/22/2022 11:40
2519,1995-10-11,Thomasville,Minnesota,29634,700,700,0,10/20/2020 21:23,10/20/2020 21:26
2520,1960-07-25,Thomasville,Mississippi,29634,950,950,0,10/20/2020 21:26,2/19/2022 12:53
2521,1977-06-10,Thomasville,Missouri,29634,700,700,0,10/20/2020 21:35,
2522,1963-02-23,Thomasville,Montana,29634,1710,1710,0,10/20/2020 21:35,3/26/2022 17:07
2523,1983-04-21,Thomasville,Nebraska,29634,700,700,0,10/20/2020 21:35,
2524,1972-09-25,Thomasville,Nevada,29634,2300,2300,0,10/20/2020 21:43,3/2/2022 21:12
2525,1963-12-02,Thomasville,New Hampshire,29634,700,700,0,10/20/2020 21:46,10/20/2020 21:48
2526,1992-05-04,Thomasville,New Jersey,29634,510,510,0,10/20/2020 21:52,3/28/2022 16:02
2527,1968-04-23,Thomasville,New Mexico,29634,3030,3030,0,10/20/2020 21:52,5/4/2022 9:06
2528,1971-11-17,Thomasville,New York,29634,600,600,0,10/20/2020 22:02,1/25/2022 19:00
2529,1981-10-03,Thomasville,North Carolina,29634,1540,1540,0,10/20/2020 22:03,5/26/2022 20:06
2530,1963-07-24,Thomasville,North Dakota,29634,450,450,0,10/20/2020 22:10,1/12/2022 11:12
2531,1996-07-04,Thomasville,Ohio,29634,1000,1000,0,10/20/2020 22:19,3/12/2022 15:33
2532,1950-03-22,Thomasville,Oklahoma,29634,610,610,0,10/20/2020 22:23,4/9/2022 10:15
2533,1967-08-26,Thomasville,Oregon,29634,700,700,0,10/20/2020 22:24,
2534,1984-04-24,Thomasville,Pennsylvania,29634,700,700,0,10/20/2020 22:25,4/6/2022 22:44
2535,1980-08-12,Thomasville,Rhode Island,29634,400,400,0,10/20/2020 22:27,10/30/2021 17:10
2536,1987-05-23,Thomasville,South Carolina,29634,700,700,0,10/20/2020 22:29,8/18/2021 21:45
2537,1959-02-26,Thomasville,South Dakota,29634,860,860,0,10/20/2020 22:37,5/8/2022 9:27
2538,1961-04-21,Thomasville,Tennessee,29634,760,760,0,10/20/2020 22:42,3/17/2022 12:00
2539,2002-05-04,Thomasville,Texas,29634,700,700,0,10/20/2020 22:49,
2540,1996-10-08,Thomasville,Utah,29634,1300,1300,0,10/20/2020 23:01,3/16/2022 18:08
2541,1985-12-03,Thomasville,Vermont,29634,700,700,0,10/20/2020 23:07,
2542,1974-10-27,Thomasville,Virginia,29634,1400,1400,0,10/20/2020 23:10,3/2/2022 20:45
2543,1958-04-11,Thomasville,Washington,29634,500,500,0,10/20/2020 23:30,1/22/2022 19:08
2544,1973-03-14,Thomasville,West Virginia,29634,400,400,0,10/20/2020 23:34,10/20/2020 23:42
2545,1998-09-02,Thomasville,Wisconsin,29634,860,860,0,10/20/2020 23:40,5/10/2021 10:45
2546,1998-05-18,Thomasville,Wyoming,29634,650,650,0,10/20/2020 23:45,2/28/2022 10:05
2547,1974-08-03,Thomasville,Alabama,29634,700,700,0,10/20/2020 23:49,
2548,2000-10-01,Thomasville,Alaska,29634,2590,2590,0,10/21/2020 0:10,4/16/2022 14:09
2549,1962-02-01,Thomasville,Arizona,29634,1020,1020,0,10/21/2020 0:10,2/22/2022 19:24
2550,1976-06-20,Thomasville,Arkansas,29634,700,700,0,10/21/2020 0:15,3/12/2022 10:44
2551,1969-06-14,Thomasville,California,29634,700,700,0,10/21/2020 0:20,11/30/2021 16:40
2552,1952-08-26,Thomasville,Colorado,29634,2800,2800,0,10/21/2020 0:34,3/19/2022 12:09
2553,1998-04-23,Thomasville,Connecticut,29634,520,520,0,10/21/2020 0:35,2/11/2022 14:02
2554,1997-04-23,Thomasville,Delaware,29634,1090,1090,0,10/21/2020 0:35,6/21/2022 11:49
2555,1969-08-10,Thomasville,District of Columbia,29634,860,860,0,10/21/2020 1:50,4/15/2022 19:24
2556,1971-05-02,Thomasville,Florida,29634,1080,1080,0,10/21/2020 6:35,4/27/2022 12:00
2557,1984-08-09,Thomasville,Georgia,29634,500,500,0,10/21/2020 10:18,10/21/2020 10:19
2558,1959-01-05,Thomasville,Hawaii,29634,610,610,0,10/21/2020 10:33,6/10/2022 16:24
2559,2002-01-04,Thomasville,Idaho,29634,900,900,0,10/21/2020 10:39,1/23/2022 15:18
2560,1984-08-26,Thomasville,Illinois,29634,1360,1360,0,10/21/2020 11:04,5/4/2022 13:54
2561,1975-10-13,Thomasville,Indiana,29634,400,400,0,10/21/2020 11:08,3/1/2022 12:01
2562,1991-05-18,Thomasville,Iowa,29634,550,550,0,10/21/2020 11:09,1/8/2022 14:19
2563,1996-05-15,Thomasville,Kansas,29634,2380,2380,0,10/21/2020 11:09,5/12/2022 23:32
2564,1982-09-23,Thomasville,Kentucky,29634,3030,3030,0,10/21/2020 11:29,5/3/2022 18:35
2565,2001-08-10,Thomasville,Louisiana,29634,700,700,0,10/21/2020 11:32,12/14/2020 9:59
2566,1955-05-19,Thomasville,Maine,29634,950,1450,500,10/21/2020 11:34,3/2/2022 20:40
2567,1954-04-01,Thomasville,Maryland,29634,400,400,0,10/21/2020 11:54,1/12/2022 19:18
2568,1972-07-28,Thomasville,Massachusetts,29634,2070,2070,0,10/21/2020 12:10,5/11/2022 18:41
2569,1972-03-26,Thomasville,Michigan,29634,620,620,0,10/21/2020 12:42,5/3/2022 19:27
2570,1974-01-17,Thomasville,Minnesota,29634,700,700,0,10/21/2020 13:00,
2571,1978-12-28,Thomasville,Mississippi,29634,700,700,0,10/21/2020 13:57,
2572,1968-04-06,Thomasville,Missouri,29634,500,500,0,10/21/2020 14:04,1/22/2022 19:56
2573,1965-09-08,Thomasville,Montana,29634,195,795,600,10/21/2020 14:16,5/15/2021 13:09
2574,2004-10-21,Thomasville,Nebraska,29634,740,740,0,10/21/2020 15:37,5/11/2021 9:41
2575,2002-04-07,Thomasville,Nevada,29634,760,760,0,10/21/2020 17:25,1/22/2022 16:21
2576,1952-10-14,Thomasville,New Hampshire,29634,1920,1920,0,10/21/2020 18:59,5/29/2022 1:26
2577,2001-11-11,Edina,Minnesota,55439,6755,7080,325,10/21/2020 19:44,4/12/2022 19:11
2578,1954-02-13,Thomasville,New Jersey,29634,1320,1320,0,10/21/2020 20:18,6/26/2022 18:41
2579,1961-04-11,Thomasville,New Mexico,29634,600,600,0,10/21/2020 23:50,3/14/2022 9:00
2580,1952-12-06,Thomasville,New York,29634,1860,1860,0,10/22/2020 7:42,4/8/2022 20:07
2581,1957-09-04,Thomasville,North Carolina,29634,410,410,0,10/22/2020 11:32,4/9/2022 14:11
2582,1965-11-08,Thomasville,North Dakota,29634,730,730,0,10/22/2020 18:13,8/22/2021 13:21
2583,1951-03-25,Thomasville,Ohio,29634,760,760,0,10/22/2020 19:12,3/14/2022 11:12
2584,1971-05-24,Thomasville,Oklahoma,29634,1250,1250,0,10/22/2020 19:13,3/2/2022 21:44
2585,1998-07-27,Thomasville,Oregon,29634,880,880,0,10/23/2020 19:57,5/5/2021 18:23
2586,2001-08-01,Thomasville,Pennsylvania,29634,4980,4980,0,10/24/2020 17:53,5/26/2022 20:25
2587,1972-08-06,Thomasville,Rhode Island,29634,300,300,0,10/26/2020 12:59,
2588,1989-05-19,Thomasville,South Carolina,29634,1550,1550,0,10/26/2020 18:44,3/14/2022 9:08
2589,1966-07-19,Thomasville,South Dakota,29634,1090,1090,0,10/27/2020 12:00,4/25/2022 21:13
2590,1967-01-01,Thomasville,Tennessee,29634,400,400,0,10/27/2020 15:26,
2591,1998-11-23,Palm Harbor,Florida,34685,20,920,900,10/28/2020 15:36,5/3/2021 17:14
2592,1999-07-27,Thomasville,Texas,29634,320,320,0,10/29/2020 15:40,8/30/2021 9:48
2593,1973-04-11,Thomasville,Utah,29634,400,400,0,10/31/2020 7:29,11/2/2020 12:22
2594,2001-09-26,Thomasville,Vermont,29634,1460,1460,0,10/31/2020 19:25,4/16/2022 16:19
2595,1970-02-22,Thomasville,Virginia,29634,2560,2560,0,11/1/2020 13:17,5/26/2022 20:08
2596,1962-07-05,Thomasville,Washington,29634,700,700,0,11/2/2020 23:02,
2597,1965-09-11,Thomasville,West Virginia,29634,2820,2820,0,11/5/2020 14:39,6/13/2022 15:47
2598,1967-05-10,Thomasville,Wisconsin,29634,700,700,0,11/9/2020 10:39,11/9/2020 10:40
2599,1965-01-17,Thomasville,Wyoming,29634,720,720,0,11/9/2020 11:23,5/2/2022 18:27
2600,1952-05-05,Thomasville,Alabama,29634,700,700,0,11/19/2020 3:48,11/25/2020 18:55
2601,2022-09-09,Thomasville,Alaska,29634,1250,1250,0,11/20/2020 16:21,3/17/2022 20:13
2602,1986-10-27,Thomasville,Arizona,29634,1260,1260,0,11/22/2020 15:32,4/2/2022 18:47
2603,1954-02-27,Thomasville,Arkansas,29634,600,600,0,11/25/2020 9:59,
2604,1974-12-26,Thomasville,California,29634,400,400,0,11/28/2020 13:07,
2605,1992-02-07,Thomasville,Colorado,29634,680,680,0,12/12/2020 18:30,6/16/2022 20:45
2606,1962-09-16,Thomasville,Connecticut,29634,700,700,0,12/14/2020 17:40,
2607,1999-03-07,Thomasville,Delaware,29634,770,770,0,12/14/2020 19:23,3/15/2022 16:39
2608,1973-10-12,Winston-Salem,North Carolina,27101,710,1010,300,12/15/2020 0:50,4/24/2021 1:53
2609,1957-12-07,Thomasville,District of Columbia,29634,400,400,0,12/29/2020 22:46,
2610,1951-03-15,Thomasville,Florida,29634,770,770,0,1/7/2021 18:07,5/22/2022 16:43
2611,1999-07-03,Thomasville,Georgia,29634,410,410,0,1/11/2021 23:09,4/18/2022 19:27
2612,1964-07-04,Thomasville,Hawaii,29634,850,850,0,1/27/2021 21:51,3/17/2022 18:49
2613,1996-12-16,Thomasville,Idaho,29634,920,920,0,2/1/2021 15:03,9/2/2021 10:00
2614,2002-03-14,Thomasville,Illinois,29634,5340,5640,300,2/1/2021 20:00,4/9/2022 16:03
2615,2001-04-13,Supply,North Carolina,28462,2230,2530,300,2/2/2021 18:36,2/12/2022 13:17
2616,1990-11-19,Thomasville,Indiana,29634,1760,1760,0,2/13/2021 14:18,12/11/2021 18:17
2617,1992-04-16,Thomasville,Iowa,29634,510,410,0,2/15/2021 13:12,4/19/2021 17:02
2618,1950-01-08,Blaine,Minnesota,55449,5310,310,0,6/29/2022 10:32,6/29/2022 10:39
2619,2001-03-12,Thomasville,Kansas,29634,1550,1550,0,2/19/2021 0:40,3/17/2022 9:54
2620,1985-02-04,Thomasville,Kentucky,29634,470,470,0,2/19/2021 17:28,6/1/2021 15:04
2621,2005-05-26,Thomasville,Louisiana,29634,1440,1440,0,2/24/2021 16:55,4/22/2022 13:41
2622,2002-09-21,Thomasville,Maine,29634,1470,1470,0,2/24/2021 17:05,2/26/2022 15:08
2623,1962-09-03,Thomasville,Maryland,29634,450,450,0,2/24/2021 17:36,12/29/2021 15:07
2624,1999-09-21,Thomasville,Massachusetts,29634,650,650,0,2/24/2021 17:37,5/2/2021 13:31
2625,2000-02-02,Thomasville,Michigan,29634,400,400,0,2/24/2021 17:44,1/12/2022 17:31
2626,2001-04-09,Winston-Salem ,North Carolina,27109,3340,3340,0,2/24/2021 17:48,6/17/2021 3:03
2627,1953-06-23,Thomasville,Minnesota,29634,270,570,300,2/24/2021 18:05,5/2/2021 22:00
2628,1990-02-11,Thomasville,Mississippi,29634,5185,5185,0,2/24/2021 18:51,5/6/2022 16:49
2629,1980-04-01,Thomasville,Missouri,29634,2720,2720,0,2/24/2021 18:55,6/11/2022 13:32
2630,1963-06-25,Thomasville,Montana,29634,300,300,0,2/24/2021 19:08,7/27/2021 20:06
2631,1990-05-20,Thomasville,Nebraska,29634,250,550,300,2/24/2021 19:47,1/20/2022 22:04
2632,1958-08-17,Thomasville,Nevada,29634,680,1180,500,2/24/2021 23:15,3/2/2022 18:42
2633,1990-02-27,Thomasville,New Hampshire,29634,780,780,0,2/24/2021 23:36,4/15/2022 8:46
2634,1960-10-12,Thomasville,New Jersey,29634,300,800,500,2/24/2021 23:39,1/20/2022 17:24
2635,1966-01-25,Thomasville,New Mexico,29634,760,760,0,2/25/2021 9:28,5/6/2021 8:38
2636,1976-05-25,Thomasville,New York,29634,10,310,300,2/25/2021 11:16,4/18/2022 18:01
2637,1994-10-03,Thomasville,North Carolina,29634,300,300,0,2/25/2021 13:00,2/25/2021 13:02
2638,1992-04-22,Thomasville,North Dakota,29634,20,320,300,2/25/2021 13:50,3/25/2022 19:08
2639,1980-02-18,Thomasville,Ohio,29634,640,640,0,2/25/2021 15:05,5/28/2022 17:34
2640,1998-06-03,Thomasville,Oklahoma,29634,0,300,300,2/25/2021 15:25,2/25/2021 15:26
2641,1980-07-14,Thomasville,Oregon,29634,0,300,300,2/25/2021 17:27,
2642,1999-12-31,Thomasville,Pennsylvania,29634,710,710,0,2/25/2021 17:45,3/11/2022 2:46
2643,2000-01-13,Thomasville,Rhode Island,29634,3040,3040,0,2/25/2021 18:05,5/11/2022 18:44
2644,1997-02-18,Thomasville,South Carolina,29634,420,420,0,2/25/2021 18:19,4/18/2022 18:01
2645,1968-05-17,Thomasville,South Dakota,29634,4570,4570,0,2/25/2021 18:22,5/11/2022 19:00
2646,1985-02-25,Thomasville,Tennessee,29634,260,560,300,2/26/2021 0:07,2/20/2022 13:19
2647,2002-08-10,Thomasville,Texas,29634,12315,13115,800,2/26/2021 0:31,6/25/2022 5:02
2648,1998-08-17,Thomasville,Utah,29634,450,450,0,2/26/2021 10:04,1/23/2022 23:04
2649,1986-02-26,Thomasville,Vermont,29634,260,560,300,2/26/2021 10:52,6/8/2021 13:58
2650,2002-06-05,Winston-Salem,North Carolina,22213,10285,10585,300,2/26/2021 10:54,4/16/2022 13:27
2651,1955-07-04,Thomasville,Virginia,29634,2080,2380,300,2/26/2021 11:04,5/3/2022 13:16
2652,1979-10-13,Thomasville,Washington,29634,7035,7335,300,2/26/2021 11:06,5/15/2022 23:12
2653,1981-11-12,Thomasville,West Virginia,29634,4485,4485,0,2/26/2021 11:22,5/27/2022 17:19
2654,1993-06-08,Thomasville,Wisconsin,29634,350,350,0,2/26/2021 11:23,6/14/2022 11:57
2655,1992-03-02,Thomasville,Wyoming,29634,0,300,300,2/26/2021 11:48,
2656,1989-12-19,Thomasville,Alabama,29634,1250,1250,0,2/26/2021 11:49,3/2/2022 20:54
2657,1981-03-01,Thomasville,Alaska,29634,3045,3045,0,2/26/2021 12:12,5/22/2021 15:32
2658,1970-09-15,Thomasville,Arizona,29634,150,450,300,2/26/2021 13:19,5/7/2022 14:30
2659,1963-05-24,Thomasville,Arkansas,29634,300,300,0,2/26/2021 14:12,2/21/2022 17:49
2660,2002-10-27,Thomasville,California,29634,90,390,300,2/26/2021 14:41,11/28/2021 21:31
2661,1982-05-17,Thomasville,Colorado,29634,1780,1780,0,2/26/2021 14:47,4/15/2022 19:17
2662,1989-02-06,Thomasville,Connecticut,29634,920,920,0,2/26/2021 15:12,6/30/2022 11:21
2663,1921-01-25,Thomasville,Delaware,29634,110,425,315,2/26/2021 15:17,4/29/2021 13:16
2664,1995-08-09,Thomasville,District of Columbia,29634,1120,1120,0,2/26/2021 16:12,4/15/2022 14:01
2665,1950-07-01,Thomasville,Florida,29634,1650,1650,0,2/26/2021 16:15,2/12/2022 16:51
2666,1976-05-09,Thomasville,Georgia,29634,20,320,300,2/26/2021 17:57,1/2/2022 19:03
2667,1953-11-10,Thomasville,Hawaii,29634,1570,1870,300,2/26/2021 18:58,4/19/2022 18:13
2668,1980-08-28,Thomasville,Idaho,29634,560,1320,760,2/26/2021 19:25,3/23/2022 9:16
2669,1992-04-03,Winston-Salem,North Carolina,27104,55,2055,2000,2/26/2021 19:43,5/19/2021 9:22
2670,1950-03-26,Thomasville,Illinois,29634,1420,1420,0,2/26/2021 20:18,5/5/2022 14:19
2671,1962-04-21,Thomasville,Indiana,29634,635,635,0,2/26/2021 21:10,3/4/2021 15:27
2672,1983-02-20,Thomasville,Iowa,29634,1330,1630,300,2/26/2021 21:22,3/25/2022 18:04
2673,1959-09-13,Thomasville,Kansas,29634,1105,1105,0,2/26/2021 22:06,4/19/2022 18:04
2674,1965-01-28,Thomasville,Kentucky,29634,600,600,0,2/27/2021 8:27,3/13/2022 10:48
2675,1960-06-21,Thomasville,Louisiana,29634,300,300,0,2/27/2021 10:44,3/5/2021 9:16
2676,2021-11-21,Thomasville,Maine,29634,325,3525,3200,2/27/2021 11:10,5/31/2021 10:47
2677,2000-08-23,Thomasville,Maryland,29634,1520,1820,300,2/27/2021 11:31,4/17/2022 13:12
2678,1976-07-16,Thomasville,Massachusetts,29634,320,320,0,2/27/2021 13:06,5/3/2021 7:20
2679,1986-07-02,Thomasville,Michigan,29634,660,660,0,2/27/2021 13:07,4/26/2021 12:33
2680,1969-02-23,Thomasville,Minnesota,29634,480,480,0,2/27/2021 14:53,5/8/2021 15:51
2681,2002-10-04,Thomasville,Mississippi,29634,3310,3310,0,2/27/2021 15:35,5/2/2022 10:01
2682,1991-12-24,Thomasville,Missouri,29634,975,975,0,2/27/2021 16:07,4/19/2022 12:40
2683,1957-10-08,Thomasville,Montana,29634,10,810,800,2/27/2021 21:48,4/30/2022 11:43
2684,1954-04-01,Thomasville,Nebraska,29634,370,720,350,2/28/2021 15:07,4/28/2022 9:07
2685,1988-12-01,Thomasville,Nevada,29634,1820,2120,300,2/28/2021 15:42,4/13/2022 10:32
2686,1998-10-14,Thomasville,New Hampshire,29634,1580,1580,0,2/28/2021 15:53,3/15/2022 16:42
2687,1978-12-09,Thomasville,New Jersey,29634,1035,1035,0,2/28/2021 16:53,2/18/2022 15:53
2688,1966-07-07,Thomasville,New Mexico,29634,750,1050,300,2/28/2021 16:55,2/11/2022 17:54
2689,2005-10-21,Thomasville,New York,29634,230,530,300,2/28/2021 17:03,5/7/2021 10:29
2690,1991-08-06,Thomasville,North Carolina,29634,1400,1400,0,2/28/2021 19:46,5/14/2022 11:28
2691,1972-12-11,Thomasville,North Dakota,29634,470,470,0,3/1/2021 8:04,11/13/2021 9:28
2692,1957-09-08,Thomasville,Ohio,29634,930,930,0,3/1/2021 9:30,3/2/2022 20:54
2693,1974-12-19,Thomasville,Oklahoma,29634,3560,3860,300,3/1/2021 9:57,4/29/2022 16:00
2694,1972-05-23,Thomasville,Oregon,29634,1520,1670,150,3/1/2021 10:00,4/26/2022 7:11
2695,1958-03-15,Thomasville,Pennsylvania,29634,330,330,0,3/1/2021 11:01,3/25/2022 18:31
2696,1961-08-02,Thomasville,Rhode Island,29634,0,300,300,3/1/2021 12:32,3/5/2021 20:11
2697,1989-08-25,Thomasville,South Carolina,29634,460,460,0,3/1/2021 12:35,3/5/2021 21:40
2698,1991-08-02,Thomasville,South Dakota,29634,350,350,0,3/1/2021 12:38,5/7/2022 17:04
2699,1956-01-16,Thomasville,Tennessee,29634,1650,2650,1000,3/1/2021 12:58,5/6/2022 18:45
2700,1973-10-13,Thomasville,Texas,29634,100,400,300,3/1/2021 14:09,1/25/2022 14:19
2701,1968-08-14,Thomasville,Utah,29634,300,300,0,3/1/2021 14:25,
2702,2001-02-15,Thomasville,Vermont,29634,3500,3500,0,3/1/2021 16:18,5/31/2022 12:20
2703,1991-03-21,Thomasville,Virginia,29634,300,300,0,3/1/2021 18:06,2/26/2022 19:21
2704,2000-08-15,Thomasville,Washington,29634,710,710,0,3/1/2021 18:19,1/17/2022 23:10
2705,1976-12-06,Thomasville,West Virginia,29634,20,320,300,3/1/2021 18:22,5/8/2021 16:36
2706,1991-06-21,Thomasville,Wisconsin,29634,350,350,0,3/1/2021 18:30,
2707,1993-12-22,Thomasville,Wyoming,29634,670,670,0,3/1/2021 18:33,4/13/2022 8:40
2708,2004-08-28,Thomasville,Alabama,29634,4200,4200,0,3/1/2021 20:24,6/20/2022 18:54
2709,1968-05-02,Thomasville,Alaska,29634,1500,1500,0,3/1/2021 20:30,3/16/2022 11:18
2710,2021-05-13,Thomasville,Arizona,29634,410,410,0,3/1/2021 20:44,3/14/2022 10:01
2711,1987-07-27,Thomasville,Arkansas,29634,1630,1630,0,3/1/2021 21:03,5/2/2022 12:42
2712,1959-09-26,Thomasville,California,29634,410,410,0,3/1/2021 21:06,1/22/2022 19:11
2713,1984-10-05,Thomasville,Colorado,29634,0,300,300,3/1/2021 21:15,
2714,1951-05-26,Thomasville,Connecticut,29634,340,340,0,3/1/2021 21:31,4/8/2022 22:00
2715,1977-06-12,Thomasville,Delaware,29634,1060,1060,0,3/1/2021 21:38,4/18/2022 23:55
2716,1967-05-12,Thomasville,District of Columbia,29634,300,300,0,3/1/2021 22:16,3/3/2021 13:13
2717,2001-03-23,Greensboro,North Carolina,27406,2620,2620,0,3/1/2021 22:17,6/3/2022 20:34
2718,2000-01-14,Whitesboro,New York,13492,2680,2680,0,3/1/2021 22:27,4/9/2022 15:47
2719,1965-12-27,Thomasville,Florida,29634,450,450,0,3/1/2021 22:58,
2720,1965-06-15,Thomasville,Georgia,29634,300,300,0,3/1/2021 23:00,3/3/2021 17:52
2721,1961-09-01,Thomasville,Hawaii,29634,320,320,0,3/1/2021 23:00,5/2/2021 16:44
2722,1966-03-04,Thomasville,Idaho,29634,1200,1200,0,3/1/2021 23:00,1/22/2022 14:43
2723,1985-05-06,Thomasville,Illinois,29634,450,450,0,3/1/2021 23:03,3/5/2021 21:41
2724,1980-05-16,Thomasville,Indiana,29634,300,300,0,3/2/2021 0:39,3/3/2021 13:22
2725,1968-02-06,Thomasville,Iowa,29634,750,750,0,3/2/2021 7:34,2/19/2022 12:55
2726,1986-01-23,Thomasville,Kansas,29634,750,750,0,3/2/2021 7:55,2/19/2022 12:51
2727,1987-08-26,Thomasville,Kentucky,29634,660,960,300,3/2/2021 12:27,5/26/2022 20:06
2728,1994-11-16,Thomasville,Louisiana,29634,400,400,0,3/2/2021 12:40,2/26/2022 15:52
2729,1962-05-12,Thomasville,Maine,29634,600,600,0,3/2/2021 13:03,3/18/2022 11:29
2730,1955-06-26,Thomasville,Maryland,29634,6960,6960,0,3/2/2021 13:11,4/2/2022 11:01
2731,2001-09-10,Thomasville,Massachusetts,29634,450,450,0,3/2/2021 13:20,
2732,1953-04-10,Thomasville,Michigan,29634,0,300,300,3/2/2021 13:41,
2733,1964-11-03,Thomasville,Minnesota,29634,450,450,0,3/2/2021 13:46,2/4/2022 1:01
2734,2000-12-01,Thomasville,Mississippi,29634,420,420,0,3/2/2021 14:03,2/19/2022 13:05
2735,1950-02-21,Thomasville,Missouri,29634,0,300,300,3/2/2021 14:18,3/5/2021 17:53
2736,1983-11-27,Thomasville,Montana,29634,20,320,300,3/2/2021 14:37,3/24/2022 18:00
2737,1978-01-11,Thomasville,Nebraska,29634,310,310,0,3/2/2021 14:57,
2738,1984-08-02,Thomasville,Nevada,29634,30,380,350,3/2/2021 15:03,3/17/2022 12:11
2739,1986-10-19,Thomasville,New Hampshire,29634,20,320,300,3/2/2021 15:05,4/15/2022 19:17
2740,1964-03-12,Thomasville,New Jersey,29634,1020,1020,0,3/2/2021 15:17,4/15/2022 19:17
2741,1983-06-28,Thomasville,New Mexico,29634,360,660,300,3/2/2021 15:21,2/3/2022 12:08
2742,1954-06-05,Thomasville,New York,29634,1400,1400,0,3/2/2021 15:25,3/2/2022 20:59
2743,1989-07-21,Thomasville,North Carolina,29634,300,300,0,3/2/2021 15:27,3/2/2022 20:43
2744,1990-12-07,Thomasville,North Dakota,29634,1375,1375,0,3/2/2021 15:33,5/13/2021 19:56
2745,1969-10-25,Thomasville,Ohio,29634,1230,1230,0,3/2/2021 15:41,5/11/2021 17:04
2746,1975-06-23,Thomasville,Oklahoma,29634,1035,1335,300,3/2/2021 15:47,5/10/2022 18:35
2747,1974-07-09,Thomasville,Oregon,29634,1305,1305,0,3/2/2021 15:49,6/13/2022 17:21
2748,1994-12-23,Thomasville,Pennsylvania,29634,410,410,0,3/2/2021 15:57,5/26/2022 20:09
2749,1969-03-08,Thomasville,Rhode Island,29634,2250,2550,300,3/2/2021 16:18,3/15/2022 13:50
2750,1996-07-23,Thomasville,South Carolina,29634,1430,1430,0,3/2/2021 16:39,4/11/2022 11:45
2751,1958-09-01,Thomasville,South Dakota,29634,1030,1030,0,3/2/2021 16:40,5/4/2022 17:58
2752,1969-05-23,Thomasville,Tennessee,29634,360,360,0,3/2/2021 16:41,2/19/2022 11:06
2753,1972-09-21,Thomasville,Texas,29634,650,650,0,3/2/2021 16:42,4/4/2022 23:04
2754,1984-09-16,Thomasville,Utah,29634,1950,2250,300,3/2/2021 16:43,3/25/2022 18:12
2755,1970-01-02,Thomasville,Vermont,29634,180,480,300,3/2/2021 16:44,6/8/2022 0:20
2756,1981-07-23,Thomasville,Virginia,29634,810,810,0,3/2/2021 16:48,2/17/2022 14:21
2757,1977-08-26,Thomasville,Washington,29634,300,300,0,3/2/2021 16:51,
2758,1988-02-22,Thomasville,West Virginia,29634,1680,1680,0,3/2/2021 18:31,4/8/2022 12:44
2759,2003-03-12,Thomasville,Wisconsin,29634,1400,1400,0,3/2/2021 18:40,6/27/2022 8:48
2760,1986-06-26,Thomasville,Wyoming,29634,1910,1910,0,3/2/2021 18:50,1/12/2022 17:55
2761,1959-04-15,Thomasville,Alabama,29634,750,1050,300,3/2/2021 18:59,2/2/2022 20:22
2762,1996-03-09,Thomasville,Alaska,29634,700,700,0,3/2/2021 19:05,1/22/2022 19:31
2763,1953-07-14,Frankfort,Kentucky,40601,3755,3780,25,3/2/2021 20:02,4/16/2022 17:36
2764,1982-07-06,Thomasville,Arizona,29634,510,510,0,3/2/2021 20:18,1/22/2022 20:22
2765,1999-01-06,Thomasville,Arkansas,29634,510,510,0,3/2/2021 20:48,5/11/2022 17:55
2766,1984-11-25,Thomasville,California,29634,310,310,0,3/2/2021 21:11,5/3/2021 13:27
2767,1987-11-18,Rockville,Maryland,20850,2610,3060,450,3/2/2021 21:26,4/30/2022 11:31
2768,2000-08-08,Thomasville,Colorado,29634,1760,2260,500,3/2/2021 21:28,3/17/2022 19:28
2769,2002-11-06,Thomasville,Connecticut,29634,2350,2350,0,3/2/2021 21:29,4/16/2022 12:30
2770,1977-11-03,Thomasville,Delaware,29634,1230,2230,1000,3/2/2021 21:40,3/2/2022 17:43
2771,1984-01-25,Thomasville,District of Columbia,29634,300,300,0,3/2/2021 21:45,3/19/2022 12:09
2772,2002-07-26,Charlotte,North Carolina,28269,2300,8800,6500,3/2/2021 21:51,6/26/2022 9:49
2773,1997-12-21,Thomasville,Florida,29634,4720,4720,0,3/2/2021 21:53,5/30/2022 20:17
2774,1988-11-13,Thomasville,Georgia,29634,4980,4980,0,3/2/2021 22:01,4/24/2022 14:01
2775,1999-08-10,Thomasville,Hawaii,29634,2310,5310,3000,3/2/2021 22:12,4/19/2022 19:08
2776,1951-03-14,Thomasville,Idaho,29634,450,450,0,3/2/2021 23:16,8/22/2021 15:30
2777,1954-09-28,Thomasville,Illinois,29634,450,950,500,3/2/2021 23:51,3/7/2022 1:21
2778,2000-07-04,Rex,Georgia,30273,16490,16790,300,3/3/2021 3:01,6/4/2022 8:44
2779,2002-01-02,Thomasville,Indiana,29634,5190,5190,0,3/3/2021 8:50,5/2/2022 9:53
2780,1983-04-16,Thomasville,Iowa,29634,0,300,300,3/3/2021 9:24,
2781,1951-05-23,Thomasville,Kansas,29634,50,360,310,3/3/2021 12:35,5/5/2022 13:08
2782,2000-07-03,Thomasville,Kentucky,29634,650,650,0,3/3/2021 13:38,11/13/2021 18:15
2783,1972-04-03,Thomasville,Louisiana,29634,530,1030,500,3/3/2021 20:01,12/11/2021 23:09
2784,1971-04-25,Thomasville,Maine,29634,310,310,0,3/3/2021 21:36,4/22/2021 21:27
2785,1971-12-21,Thomasville,Maryland,29634,980,1280,300,3/4/2021 9:44,3/29/2022 17:30
2786,2001-02-28,Thomasville,Massachusetts,29634,800,800,0,3/4/2021 12:30,5/3/2022 13:00
2787,2000-06-01,Thomasville,Michigan,29634,3350,3350,0,3/4/2021 12:35,3/26/2022 22:55
2788,1974-03-12,Thomasville,Minnesota,29634,750,750,0,3/4/2021 14:54,4/2/2022 11:55
2789,1968-07-13,Thomasville,Mississippi,29634,450,450,0,3/4/2021 15:54,10/1/2021 20:55
2790,1957-01-05,Thomasville,Missouri,29634,360,660,300,3/4/2021 18:46,2/12/2022 14:49
2791,1978-05-02,Thomasville,Montana,29634,1240,1240,0,3/4/2021 21:06,11/28/2021 12:04
2792,1952-09-28,Thomasville,Nebraska,29634,2300,2300,0,3/4/2021 23:02,11/14/2021 0:21
2793,1952-08-27,Thomasville,Nevada,29634,1130,1430,300,3/5/2021 10:26,3/15/2022 11:02
2794,1988-04-13,Thomasville,New Hampshire,29634,0,1300,1300,3/5/2021 10:55,3/2/2022 19:46
2795,1955-02-18,Thomasville,New Jersey,29634,130,430,300,3/5/2021 11:10,5/3/2022 13:23
2796,1960-02-08,Thomasville,New Mexico,29634,2020,2020,0,3/5/2021 12:59,3/9/2022 19:10
2797,1960-09-08,Thomasville,New York,29634,835,835,0,3/5/2021 13:11,5/10/2021 18:02
2798,1974-01-14,Thomasville,North Carolina,29634,340,340,0,3/5/2021 17:40,2/26/2022 18:12
2799,1963-09-02,Thomasville,North Dakota,29634,10,310,300,3/5/2021 17:43,3/10/2021 8:37
2800,2002-02-20,Thomasville,Ohio,29634,1140,1140,0,3/5/2021 20:23,4/16/2022 16:33
2801,2001-05-24,Thomasville,Oklahoma,29634,4610,4610,0,3/5/2021 20:37,4/18/2022 17:20
2802,1984-07-12,Thomasville,Oregon,29634,70,370,300,3/6/2021 2:11,6/30/2021 2:00
2803,1956-12-14,Chapel Hill,North Carolina,27517,8180,8580,400,3/6/2021 7:47,6/29/2022 14:33
2804,1986-10-11,Thomasville,Pennsylvania,29634,310,310,0,3/6/2021 12:58,8/30/2021 9:00
2805,1976-10-19,Thomasville,Rhode Island,29634,620,620,0,3/6/2021 13:47,4/30/2022 8:59
2806,1974-10-01,Thomasville,South Carolina,29634,390,390,0,3/6/2021 17:59,4/29/2022 16:01
2807,1996-02-25,Thomasville,South Dakota,29634,870,1170,300,3/6/2021 19:51,3/2/2022 18:18
2808,1973-10-02,Thomasville,Tennessee,29634,400,400,0,3/6/2021 19:52,10/2/2021 15:25
2809,2003-01-23,Thomasville,Texas,29634,310,310,0,3/7/2021 12:14,12/11/2021 21:16
2810,1977-12-09,Thomasville,Utah,29634,500,500,0,3/7/2021 13:38,1/12/2022 17:14
2811,1995-08-13,Thomasville,Vermont,29634,2090,2290,200,3/7/2021 14:52,5/8/2022 10:05
2812,1996-05-05,Thomasville,Virginia,29634,360,360,0,3/7/2021 15:10,5/7/2021 10:29
2813,1971-02-23,Thomasville,Washington,29634,330,330,0,3/7/2021 16:04,5/2/2021 19:55
2814,2000-10-01,Aurora ,New York,13026,1980,1980,0,3/7/2021 17:44,1/17/2022 8:53
2815,1991-02-16,Piedmont,California,94611,890,1350,460,3/7/2021 17:56,4/11/2022 17:04
2816,1992-03-02,Thomasville,West Virginia,29634,350,850,500,3/7/2021 18:42,1/26/2022 22:32
2817,1987-01-13,Thomasville,Wisconsin,29634,300,300,0,3/7/2021 19:14,
2818,1960-03-11,Thomasville,Wyoming,29634,40,340,300,3/7/2021 20:49,3/12/2021 12:45
2819,1995-10-23,Thomasville,Alabama,29634,350,350,0,3/7/2021 20:49,6/14/2021 11:30
2820,1985-02-09,Thomasville,Alaska,29634,310,310,0,3/7/2021 20:50,4/27/2021 19:50
2821,1961-05-12,Thomasville,Arizona,29634,1710,1710,0,3/7/2021 23:07,3/23/2022 9:22
2822,1956-10-03,Thomasville,Arkansas,29634,1620,1920,300,3/8/2021 10:37,3/21/2022 15:31
2823,2001-10-01,Thomasville,California,29634,830,830,0,3/8/2021 10:58,4/29/2022 18:01
2824,1973-08-20,Thomasville,Colorado,29634,320,820,500,3/8/2021 11:34,4/8/2022 21:52
2825,1974-05-14,Thomasville,Connecticut,29634,420,420,0,3/8/2021 12:37,5/10/2021 11:06
2826,1988-08-27,Thomasville,Delaware,29634,1355,9855,8500,3/8/2021 18:25,5/19/2022 11:09
2827,1999-10-28,Thomasville,District of Columbia,29634,510,1510,1000,3/8/2021 21:05,5/29/2022 17:44
2828,1966-08-19,Thomasville,Florida,29634,1000,1000,0,3/9/2021 16:01,1/31/2022 18:52
2829,1981-07-28,Thomasville,Georgia,29634,480,480,0,3/9/2021 20:49,11/30/2021 18:16
2830,2000-05-04,Thomasville,Hawaii,29634,300,300,0,3/9/2021 20:55,10/26/2021 22:30
2831,1962-04-19,Thomasville,Idaho,29634,700,700,0,3/10/2021 10:51,11/13/2021 19:24
2832,1996-05-20,Thomasville,Illinois,29634,1340,1540,200,3/10/2021 12:40,8/26/2021 17:02
2833,1986-04-10,Thomasville,Indiana,29634,720,870,150,3/10/2021 15:52,4/8/2022 21:53
2834,1970-06-20,Thomasville,Iowa,29634,5930,5930,0,3/10/2021 17:18,5/6/2022 12:00
2835,1992-09-26,Thomasville,Kansas,29634,20,320,300,3/10/2021 19:10,3/15/2022 10:19
2836,1983-01-27,Thomasville,Kentucky,29634,2800,3300,500,3/10/2021 23:04,4/18/2022 18:35
2837,1989-04-19,Thomasville,Louisiana,29634,1200,1200,0,3/11/2021 11:39,2/26/2022 13:12
2838,1992-12-18,Thomasville,Maine,29634,610,610,0,3/11/2021 12:18,3/13/2021 12:02
2839,1999-12-11,Thomasville,Maryland,29634,3020,3020,0,3/11/2021 14:19,6/30/2022 23:18
2840,1982-07-24,Thomasville,Massachusetts,29634,30,330,300,3/11/2021 16:26,
2841,1980-04-02,Thomasville,Michigan,29634,410,410,0,3/11/2021 19:13,11/13/2021 21:42
2842,1964-08-03,Thomasville,Minnesota,29634,420,420,0,3/11/2021 20:10,9/3/2021 20:06
2843,1990-09-13,Thomasville,Mississippi,29634,350,350,0,3/11/2021 20:43,2/22/2022 9:56
2844,1981-01-11,Thomasville,Missouri,29634,920,920,0,3/11/2021 22:54,1/14/2022 15:00
2845,2000-10-10,Thomasville,Montana,29634,600,1100,500,3/12/2021 10:31,3/5/2022 13:50
2846,1956-12-24,Thomasville,Nebraska,29634,560,1560,1000,3/12/2021 11:36,3/25/2022 18:29
2847,1986-02-10,Thomasville,Nevada,29634,310,310,0,3/12/2021 17:36,1/22/2022 19:14
2848,1965-10-05,Thomasville,New Hampshire,29634,320,320,0,3/12/2021 17:58,3/2/2022 18:29
2849,1994-10-02,Thomasville,New Jersey,29634,346,346,0,3/12/2021 19:09,7/1/2021 17:34
2850,1970-05-27,Thomasville,New Mexico,29634,320,820,500,3/13/2021 12:59,3/4/2022 17:33
2851,2003-05-06,Thomasville,New York,29634,1720,1720,0,3/13/2021 16:56,5/17/2022 10:09
2852,1963-11-10,Thomasville,North Carolina,29634,900,900,0,3/14/2021 21:14,1/8/2022 13:46
2853,1957-11-07,Thomasville,North Dakota,29634,320,320,0,3/15/2021 19:28,4/29/2022 14:55
2854,1994-08-01,Thomasville,Ohio,29634,440,440,0,3/15/2021 22:29,1/12/2022 18:35
2855,1974-04-12,Thomasville,Oklahoma,29634,1480,1480,0,3/17/2021 11:32,4/16/2022 16:40
2856,1986-06-24,Thomasville,Oregon,29634,350,350,0,3/17/2021 21:12,5/11/2021 9:34
2857,1966-11-10,Thomasville,Pennsylvania,29634,310,310,0,3/17/2021 21:40,
2858,1967-08-12,Thomasville,Rhode Island,29634,410,410,0,3/18/2021 14:24,2/12/2022 14:04
2859,1987-04-18,Thomasville,South Carolina,29634,300,300,0,3/20/2021 11:33,
2860,1955-03-01,Thomasville,South Dakota,29634,310,310,0,3/20/2021 11:36,3/16/2022 19:43
2861,1968-04-03,Thomasville,Tennessee,29634,350,350,0,3/20/2021 11:58,4/15/2022 19:05
2862,1977-02-16,Thomasville,Texas,29634,450,450,0,3/21/2021 12:55,3/21/2022 11:21
2863,1974-02-05,Thomasville,Utah,29634,310,310,0,3/21/2021 12:56,1/23/2022 7:41
2864,1974-07-15,Thomasville,Vermont,29634,770,770,0,3/21/2021 13:00,5/1/2021 18:42
2865,1993-06-10,Thomasville,Virginia,29634,450,450,0,3/21/2021 13:02,11/27/2021 15:35
2866,1962-07-23,Thomasville,Washington,29634,4430,4430,0,3/21/2021 13:39,7/1/2022 7:58
2867,1966-09-21,Thomasville,West Virginia,29634,1900,1900,0,3/24/2021 17:09,3/16/2022 15:52
2868,1975-05-09,Thomasville,Wisconsin,29634,350,350,0,3/26/2021 20:48,6/11/2021 6:49
2869,1999-04-03,Thomasville,Wyoming,29634,1670,1670,0,3/27/2021 19:24,4/23/2022 8:37
2870,2000-08-23,Thomasville,Alabama,29634,1720,1720,0,3/28/2021 12:47,2/26/2022 14:14
2871,2002-03-27,Thomasville,Alaska,29634,310,310,0,3/29/2021 11:05,8/12/2021 10:36
2872,1997-04-13,Thomasville,Arizona,29634,10,310,300,3/29/2021 11:12,3/30/2021 16:00
2873,1998-04-15,Thomasville,Arkansas,29634,2360,3360,1000,3/29/2021 14:40,6/17/2022 9:18
2874,1988-02-23,Thomasville,California,29634,300,300,0,3/29/2021 17:59,
2875,2001-03-28,Thomasville,Colorado,29634,300,300,0,3/29/2021 21:14,
2876,2003-12-22,Thomasville,Connecticut,29634,2780,2780,0,3/30/2021 13:23,4/16/2022 14:05
2877,2004-08-23,Thomasville,Delaware,29634,310,310,0,3/30/2021 13:27,4/19/2022 6:37
2878,1995-11-20,Thomasville,District of Columbia,29634,2600,2600,0,3/30/2021 13:27,5/27/2022 1:08
2879,1955-05-04,Thomasville,Florida,29634,860,860,0,3/30/2021 14:00,3/19/2022 15:56
2880,1954-11-16,Thomasville,Georgia,29634,1140,1140,0,3/30/2021 16:12,4/19/2022 17:43
2881,1991-12-23,Thomasville,Hawaii,29634,1140,1140,0,3/31/2021 11:14,5/3/2022 18:02
2882,1954-11-28,Thomasville,Idaho,29634,440,440,0,4/1/2021 15:45,2/12/2022 15:05
2883,1991-08-03,Thomasville,Illinois,29634,330,330,0,4/5/2021 12:38,4/8/2022 19:03
2884,2005-07-10,Thomasville,Indiana,29634,800,800,0,4/5/2021 21:47,5/2/2022 16:55
2885,1958-10-25,Thomasville,Iowa,29634,350,350,0,4/6/2021 21:04,9/18/2021 14:32
2886,1975-01-14,Thomasville,Kansas,29634,340,340,0,4/6/2021 21:13,5/27/2022 8:17
2887,1950-06-09,Thomasville,Kentucky,29634,330,330,0,4/7/2021 12:30,4/29/2021 13:54
2888,1960-10-05,Thomasville,Louisiana,29634,860,860,0,4/7/2021 13:08,3/2/2022 20:04
2889,1960-08-19,Winston-Salem,North Carolina,27109,870,1170,300,4/7/2021 19:18,5/17/2022 12:31
2890,1977-08-20,Thomasville,Maine,29634,420,420,0,4/8/2021 10:01,5/11/2021 21:06
2891,1956-10-04,Thomasville,Maryland,29634,580,580,0,4/8/2021 12:39,4/27/2021 17:13
2892,1989-06-05,Winston-Salem,North Carolina,27109,2670,2720,50,4/8/2021 13:44,6/23/2022 13:23
2893,2000-11-29,Winston-Salem,North Carolina,27106,2100,2500,400,4/8/2021 13:50,6/30/2022 0:48
2894,1979-07-23,Thomasville,Massachusetts,29634,620,620,0,4/8/2021 13:51,3/16/2022 17:22
2895,1970-03-25,Thomasville,Michigan,29634,1320,1320,0,4/8/2021 13:54,3/16/2022 1:08
2896,2000-04-22,Thomasville,Minnesota,29634,750,750,0,4/8/2021 13:56,1/14/2022 10:17
2897,1977-08-15,Thomasville,Mississippi,29634,1010,1010,0,4/8/2021 14:13,3/25/2022 18:08
2898,2000-02-26,Thomasville,Missouri,29634,880,880,0,4/8/2021 14:18,5/26/2022 20:06
2899,1970-08-25,Thomasville,Montana,29634,2100,2100,0,4/8/2021 14:19,3/18/2022 16:00
2900,1982-12-13,Thomasville,Nebraska,29634,580,580,0,4/8/2021 14:23,9/18/2021 15:37
2901,1971-01-03,Thomasville,Nevada,29634,530,530,0,4/8/2021 14:44,4/17/2022 11:16
2902,1963-12-27,Thomasville,New Hampshire,29634,410,410,0,4/8/2021 15:03,1/22/2022 19:44
2903,1986-07-13,Winston-Salem,North Carolina,27106,635,710,75,4/8/2021 15:08,3/19/2022 16:38
2904,2000-10-16,Thomasville,New Jersey,29634,2320,2320,0,4/8/2021 15:08,3/25/2022 18:12
2905,1993-08-10,Thomasville,New Mexico,29634,910,910,0,4/8/2021 15:11,2/19/2022 11:04
2906,1977-07-08,Thomasville,New York,29634,1110,1110,0,4/8/2021 16:10,5/6/2022 19:32
2907,1979-06-23,Thomasville,North Carolina,29634,300,300,0,4/8/2021 16:26,3/19/2022 16:43
2908,1986-05-18,Thomasville,North Dakota,29634,760,760,0,4/8/2021 16:34,3/26/2022 20:51
2909,1969-01-04,Thomasville,Ohio,29634,300,300,0,4/8/2021 18:33,3/19/2022 16:23
2910,1999-11-28,Thomasville,Oklahoma,29634,420,420,0,4/8/2021 20:38,3/27/2022 13:10
2911,2002-08-12,Thomasville,Oregon,29634,340,340,0,4/9/2021 9:08,1/22/2022 19:25
2912,1953-07-21,Thomasville,Pennsylvania,29634,790,790,0,4/9/2021 12:20,5/31/2022 19:03
2913,1982-11-03,Thomasville,Rhode Island,29634,310,310,0,4/9/2021 13:06,9/3/2021 19:08
2914,1955-02-22,Greensboro,North Carolina,27455,520,570,50,4/9/2021 13:10,4/18/2022 10:57
2915,1968-11-01,Thomasville,South Carolina,29634,470,470,0,4/9/2021 15:08,4/19/2022 13:16
2916,2000-01-09,Winston-Salem,North Carolina,2492,60,510,450,4/9/2021 15:26,2/20/2022 16:20
2917,1967-10-25,Thomasville,South Dakota,29634,2660,2660,0,4/9/2021 17:25,2/12/2022 17:46
2918,1981-02-23,Thomasville,Tennessee,29634,3830,3830,0,4/9/2021 17:51,5/11/2022 17:52
2919,1998-11-28,Thomasville,Texas,29634,480,480,0,4/9/2021 20:44,5/11/2021 12:40
2920,1951-10-17,Thomasville,Utah,29634,310,310,0,4/10/2021 9:06,4/10/2021 9:08
2921,1974-01-28,Thomasville,Vermont,29634,890,890,0,4/10/2021 10:16,5/23/2022 14:56
2922,1992-03-20,Thomasville,Virginia,29634,1190,1190,0,4/10/2021 10:44,5/11/2022 19:44
2923,1976-10-19,Thomasville,Washington,29634,360,360,0,4/10/2021 11:35,4/16/2021 19:06
2924,1996-01-21,Thomasville,West Virginia,29634,1670,1670,0,4/10/2021 13:04,4/10/2022 12:45
2925,1965-12-03,Thomasville,Wisconsin,29634,1010,1010,0,4/10/2021 15:09,12/1/2021 10:47
2926,1981-09-16,Thomasville,Wyoming,29634,320,320,0,4/10/2021 21:17,8/27/2021 13:56
2927,1988-08-05,Thomasville,Alabama,29634,8320,8320,0,4/12/2021 19:05,6/29/2022 14:36
2928,2004-01-18,Thomasville,Alaska,29634,750,750,0,4/14/2021 19:06,1/20/2022 19:11
2929,2005-05-15,Thomasville,Arizona,29634,510,510,0,4/15/2021 9:25,4/8/2022 12:43
2930,1985-10-23,Thomasville,Arkansas,29634,2360,2360,0,4/15/2021 17:01,2/19/2022 13:01
2931,1997-06-18,Winston-Salem ,North Carolina,27101,430,430,0,4/15/2021 18:20,4/23/2021 11:21
2932,1952-07-08,Thomasville,California,29634,320,320,0,4/15/2021 18:47,8/21/2021 13:00
2933,1976-06-01,Thomasville,Colorado,29634,340,340,0,4/15/2021 19:52,4/30/2021 13:09
2934,1974-01-19,Thomasville,Connecticut,29634,560,710,150,4/16/2021 16:27,5/10/2021 16:44
2935,1973-03-19,Thomasville,Delaware,29634,1540,2040,500,4/16/2021 19:31,5/3/2022 17:32
2936,1988-09-03,Thomasville,District of Columbia,29634,1940,1940,0,4/16/2021 19:41,5/11/2022 18:47
2937,1987-12-17,Thomasville,Florida,29634,1180,1180,0,4/16/2021 19:41,5/11/2022 23:45
2938,1951-09-13,Thomasville,Georgia,29634,1470,1970,500,4/16/2021 19:42,5/31/2022 16:08
2939,2004-01-15,Thomasville,Hawaii,29634,360,360,0,4/16/2021 19:57,6/27/2021 10:56
2940,1951-06-09,Thomasville,Idaho,29634,750,750,0,4/17/2021 11:02,3/19/2022 15:45
2941,1956-09-21,Thomasville,Illinois,29634,1040,1040,0,4/18/2021 19:23,1/31/2022 12:13
2942,2001-10-12,Thomasville,Indiana,29634,110,110,0,4/21/2021 10:47,4/21/2021 10:49
2943,1961-10-03,Thomasville,Iowa,29634,110,110,0,4/21/2021 10:53,4/21/2021 10:55
2944,1972-07-25,Thomasville,Kansas,29634,110,110,0,4/21/2021 10:55,4/21/2021 10:58
2945,2000-12-23,Thomasville,Kentucky,29634,1080,1080,0,4/21/2021 18:04,5/6/2022 11:53
2946,1998-03-17,Thomasville,Louisiana,29634,510,510,0,4/23/2021 16:49,5/10/2021 16:08
2947,1994-07-17,Thomasville,Maine,29634,1770,1770,0,4/24/2021 21:15,2/5/2022 21:18
2948,2021-05-09,Thomasville,Maryland,29634,720,720,0,4/26/2021 10:10,6/2/2021 19:38
2949,2021-03-29,Thomasville,Massachusetts,29634,2890,2890,0,4/26/2021 10:11,3/23/2022 18:53
2950,1983-05-22,Thomasville,Michigan,29634,440,440,0,4/26/2021 10:12,5/17/2022 11:40
2951,2003-07-12,Thomasville,Minnesota,29634,570,570,0,4/26/2021 10:16,5/9/2021 19:05
2952,1988-12-14,Thomasville,Mississippi,29634,320,320,0,4/26/2021 10:51,5/10/2021 12:13
2953,1999-02-02,Thomasville,Missouri,29634,690,690,0,4/26/2021 11:24,3/23/2022 10:26
2954,1956-11-21,Thomasville,Montana,29634,340,340,0,4/26/2021 13:45,5/2/2021 16:14
2955,2001-03-01,Thomasville,Nebraska,29634,1030,1530,500,4/26/2021 14:49,5/5/2022 19:56
2956,1965-08-08,Thomasville,Nevada,29634,1660,1660,0,4/26/2021 23:13,3/19/2022 12:12
2957,1986-04-13,Thomasville,New Hampshire,29634,740,740,0,4/27/2021 9:26,9/9/2021 9:22
2958,1983-04-02,Thomasville,New Jersey,29634,1630,1630,0,4/27/2021 11:28,2/2/2022 18:53
2959,1953-06-17,Thomasville,New Mexico,29634,320,320,0,4/27/2021 12:59,5/9/2021 17:14
2960,1981-10-24,Thomasville,New York,29634,310,310,0,4/27/2021 13:52,4/27/2021 13:52
2961,1975-11-01,Thomasville,North Carolina,29634,330,330,0,4/27/2021 17:08,9/28/2021 12:29
2962,1989-07-16,Thomasville,North Dakota,29634,870,870,0,4/27/2021 21:40,11/13/2021 17:38
2963,1956-04-22,Thomasville,Ohio,29634,4810,4810,0,4/28/2021 13:44,6/29/2022 14:46
2964,2000-09-12,Thomasville,Oklahoma,29634,2510,3510,1000,4/29/2021 11:05,6/30/2022 21:13
2965,1996-12-06,Thomasville,Oregon,29634,2160,2160,0,4/29/2021 11:30,5/11/2022 14:28
2966,1985-03-23,Thomasville,Pennsylvania,29634,420,420,0,4/29/2021 13:19,11/13/2021 18:08
2967,1996-01-15,Thomasville,Rhode Island,29634,430,430,0,4/29/2021 13:38,12/1/2021 10:48
2968,1982-07-09,Thomasville,South Carolina,29634,310,310,0,4/29/2021 14:01,5/24/2021 11:35
2969,1991-07-16,Thomasville,South Dakota,29634,320,320,0,4/29/2021 16:05,4/30/2021 15:44
2970,1995-04-11,Thomasville,Tennessee,29634,330,330,0,4/29/2021 17:29,4/30/2021 17:38
2971,1989-03-01,Thomasville,Texas,29634,850,850,0,4/29/2021 20:10,2/9/2022 12:30
2972,1979-03-19,Thomasville,Utah,29634,560,560,0,4/29/2021 20:49,5/11/2021 9:30
2973,1999-01-19,Thomasville,Vermont,29634,780,780,0,4/30/2021 12:02,2/25/2022 16:24
2974,1996-01-25,Thomasville,Virginia,29634,660,660,0,4/30/2021 14:26,5/9/2021 18:26
2975,1960-02-03,Thomasville,Washington,29634,630,630,0,4/30/2021 18:42,12/1/2021 10:27
2976,1979-09-03,Thomasville,West Virginia,29634,660,660,0,5/1/2021 13:36,2/8/2022 21:21
2977,1988-05-03,Thomasville,Wisconsin,29634,1220,1220,0,5/1/2021 13:44,5/12/2021 12:14
2978,1987-02-16,Thomasville,Wyoming,29634,4060,4060,0,5/2/2021 11:02,4/21/2022 21:02
2979,1970-08-05,Thomasville,Alabama,29634,320,320,0,5/2/2021 17:37,5/3/2021 16:37
2980,1979-07-06,Thomasville,Alaska,29634,1690,1690,0,5/3/2021 16:13,4/7/2022 17:29
2981,1955-10-25,Thomasville,Arizona,29634,430,430,0,5/4/2021 8:24,5/17/2022 16:01
2982,1993-09-12,Thomasville,Arkansas,29634,310,310,0,5/4/2021 13:54,5/4/2021 13:54
2983,1989-04-05,Thomasville,California,29634,310,310,0,5/4/2021 13:56,5/4/2021 13:56
2984,1961-09-16,Thomasville,Colorado,29634,310,310,0,5/4/2021 16:11,5/4/2021 16:12
2985,1964-02-08,Thomasville,Connecticut,29634,310,310,0,5/4/2021 20:35,5/4/2021 20:35
2986,2001-11-27,Thomasville,Delaware,29634,4830,4830,0,5/5/2021 4:42,5/30/2022 2:28
2987,1984-03-15,Thomasville,District of Columbia,29634,310,310,0,5/5/2021 9:44,5/5/2021 9:44
2988,2002-04-10,Thomasville,Florida,29634,310,310,0,5/5/2021 9:48,5/5/2021 9:48
2989,1950-01-08,Thomasville,Georgia,29634,310,310,0,5/6/2021 15:10,5/6/2021 15:10
2990,1991-09-08,Thomasville,Hawaii,29634,310,310,0,5/6/2021 15:11,5/6/2021 15:11
2991,1984-02-05,Thomasville,Idaho,29634,1790,1790,0,5/6/2021 15:13,5/7/2022 15:49
2992,1976-12-06,Thomasville,Illinois,29634,310,310,0,5/7/2021 9:14,5/7/2021 9:14
2993,1979-01-18,Thomasville,Indiana,29634,420,420,0,5/7/2021 11:06,3/15/2022 19:22
2994,1955-09-26,Thomasville,Iowa,29634,320,320,0,5/7/2021 16:20,11/16/2021 18:28
2995,1973-01-02,Thomasville,Kansas,29634,310,310,0,5/7/2021 17:22,5/7/2021 19:46
2996,1988-03-27,Thomasville,Kentucky,29634,320,320,0,5/7/2021 22:34,3/7/2022 16:56
2997,1961-05-02,Thomasville,Louisiana,29634,310,310,0,5/8/2021 10:09,5/8/2021 10:09
2998,1977-01-05,Thomasville,Maine,29634,310,310,0,5/8/2021 10:11,5/8/2021 10:11
2999,1950-04-25,Thomasville,Maryland,29634,320,320,0,5/8/2021 15:36,5/9/2021 23:39
3000,1986-10-09,Thomasville,Massachusetts,29634,670,670,0,5/8/2021 21:22,4/18/2022 18:17
3001,1966-01-28,Thomasville,Michigan,29634,1870,1870,0,5/8/2021 22:28,5/3/2022 15:07
3002,2003-06-24,Thomasville,Minnesota,29634,5115,6115,1000,5/9/2021 11:10,6/30/2022 13:50
3003,1975-04-25,Thomasville,Mississippi,29634,310,310,0,5/9/2021 14:02,5/9/2021 20:46
3004,2001-11-12,Thomasville,Missouri,29634,1570,1570,0,5/9/2021 15:01,6/21/2022 19:17
3005,1966-03-08,Thomasville,Montana,29634,310,310,0,5/11/2021 12:12,5/26/2021 12:33
3006,1964-11-15,Thomasville,Nebraska,29634,3950,3950,0,5/17/2021 8:46,5/23/2022 14:21
3007,1972-12-01,Thomasville,Nevada,29634,920,920,0,5/22/2021 14:57,3/23/2022 20:13
3008,2000-12-11,Thomasville,New Hampshire,29634,850,850,0,6/3/2021 15:58,3/17/2022 12:02
3009,2000-10-12,Thomasville,New Jersey,29634,3270,3270,0,6/5/2021 12:55,4/29/2022 22:59
3010,1998-09-21,Thomasville,New Mexico,29634,2100,2100,0,6/15/2021 0:25,3/2/2022 20:35
3011,1999-06-21,Winston-Salem,North Carolina,27106,800,2800,2000,6/30/2021 17:13,3/19/2022 20:14
3012,1999-02-04,Winston-Salem,North Carolina,27106,4780,4780,0,7/15/2021 11:07,5/3/2022 14:38
3013,2001-08-03,Malvern,Pennsylvania,19355,5160,5160,0,7/20/2021 10:50,7/1/2022 3:02
3014,1996-04-07,Thomasville,New York,29634,1560,2560,1000,7/22/2021 17:21,4/15/2022 18:54
3015,1983-09-22,Thomasville,North Carolina,29634,6090,6590,500,7/29/2021 20:43,5/27/2022 12:39
3016,1995-07-16,Thomasville,North Dakota,29634,6920,7420,500,7/31/2021 11:30,6/30/2022 8:08
3017,1999-04-16,Thomasville,Ohio,29634,2610,2610,0,8/2/2021 18:20,4/8/2022 18:53
3018,1953-12-11,Thomasville,Oklahoma,29634,2610,3610,1000,8/3/2021 10:07,6/30/2022 17:47
3019,2002-10-17,Thomasville,Oregon,29634,1690,2190,500,8/4/2021 18:04,6/30/2022 18:44
3020,2003-04-11,Thomasville,Pennsylvania,29634,2300,2300,0,8/6/2021 8:27,3/16/2022 19:09
3021,2003-01-23,Thomasville,Rhode Island,29634,7380,7380,0,8/7/2021 10:25,5/8/2022 9:24
3022,2003-06-16,Huntersville,North Carolina,28078,1860,1860,0,8/9/2021 1:40,5/20/2022 15:39
3023,1999-04-04,Thomasville,South Carolina,29634,8780,8780,0,8/9/2021 13:55,6/10/2022 8:57
3024,1956-09-22,Thomasville,South Dakota,29634,5070,13570,8500,8/9/2021 19:42,5/14/2022 21:48
3025,2002-12-20,Thomasville,Tennessee,29634,660,660,0,8/10/2021 10:47,1/19/2022 11:39
3026,1962-02-12,Thomasville,Texas,29634,1250,1250,0,8/10/2021 20:40,3/13/2022 22:15
3027,1980-09-22,Thomasville,Utah,29634,7790,7790,0,8/10/2021 23:07,6/30/2022 16:54
3028,2000-04-27,Thomasville,Vermont,29634,1340,2840,1500,8/10/2021 23:10,4/27/2022 11:59
3029,2001-05-25,Thomasville,Virginia,29634,2095,2095,0,8/11/2021 11:17,5/6/2022 22:45
3030,1969-04-25,Thomasville,Washington,29634,2670,2670,0,8/11/2021 19:53,3/13/2022 10:32
3031,2003-04-09,Thomasville,West Virginia,29634,15015,15015,0,8/13/2021 19:19,6/14/2022 6:20
3032,1999-06-15,Thomasville,Wisconsin,29634,1300,1300,0,8/14/2021 16:20,3/30/2022 18:34
3033,2003-08-07,Thomasville,Wyoming,29634,6010,7010,1000,8/14/2021 17:36,3/13/2022 21:30
3034,1954-08-22,Thomasville,Alabama,29634,7645,7645,0,8/16/2021 0:23,3/20/2022 10:53
3035,1988-05-23,Thomasville,Alaska,29634,1470,1470,0,8/18/2021 9:14,4/8/2022 18:19
3036,2002-09-10,Thomasville,Arizona,29634,660,660,0,8/18/2021 9:14,12/28/2021 19:30
3037,1960-12-02,Thomasville,Arkansas,29634,3510,3510,0,8/18/2021 9:15,5/26/2022 20:06
3038,1983-10-27,Thomasville,California,29634,460,460,0,8/18/2021 9:15,4/7/2022 19:24
3039,2002-10-28,Thomasville,Colorado,29634,1880,1880,0,8/18/2021 9:15,4/22/2022 20:10
3040,2003-10-14,Thomasville,Connecticut,29634,4020,4020,0,8/18/2021 9:15,4/19/2022 16:50
3041,1959-09-02,Thomasville,Delaware,29634,6760,6760,0,8/18/2021 9:15,4/9/2022 17:40
3042,1998-05-16,Thomasville,District of Columbia,29634,1740,2240,500,8/18/2021 9:16,5/22/2022 16:00
3043,2003-02-28,Thomasville,Florida,29634,860,860,0,8/18/2021 9:16,4/8/2022 8:59
3044,1956-08-09,Thomasville,Georgia,29634,6795,6795,0,8/18/2021 9:16,4/10/2022 17:42
3045,2002-11-08,Thomasville,Hawaii,29634,1220,1220,0,8/18/2021 9:16,5/23/2022 23:17
3046,1977-09-16,Thomasville,Idaho,29634,4360,4360,0,8/18/2021 9:16,6/21/2022 10:21
3047,2003-03-07,Thomasville,Illinois,29634,15850,15850,0,8/18/2021 9:17,5/31/2022 0:33
3048,1959-11-20,Thomasville,Indiana,29634,910,910,0,8/18/2021 9:22,4/18/2022 10:59
3049,2002-12-02,Thomasville,Iowa,29634,4910,4910,0,8/18/2021 9:38,5/26/2022 20:06
3050,1994-11-22,Thomasville,Kansas,29634,2490,2490,0,8/18/2021 9:41,3/24/2022 16:53
3051,2003-04-15,Thomasville,Kentucky,29634,6715,6715,0,8/18/2021 9:45,4/26/2022 18:46
3052,2003-03-05,Thomasville,Louisiana,29634,4140,4540,400,8/18/2021 9:48,4/18/2022 18:02
3053,1980-04-01,Thomasville,Maine,29634,1460,1460,0,8/18/2021 9:51,4/8/2022 19:38
3054,2003-06-10,Thomasville,Maryland,29634,3190,3190,0,8/18/2021 10:05,5/28/2022 17:11
3055,2002-06-10,Bourne,Massachusetts,2532,10890,28890,18000,8/18/2021 10:05,6/24/2022 14:25
3056,1977-05-16,Thomasville,Massachusetts,29634,1600,1600,0,8/18/2021 10:08,3/6/2022 11:26
3057,1961-07-23,Thomasville,Michigan,29634,17680,17680,0,8/18/2021 10:08,6/30/2022 15:58
3058,1991-07-09,Thomasville,Minnesota,29634,390,390,0,8/18/2021 10:10,5/29/2022 14:31
3059,2003-02-03,Thomasville,Mississippi,29634,990,990,0,8/18/2021 10:13,1/22/2022 19:22
3060,1960-11-12,Thomasville,Missouri,29634,1580,2580,1000,8/18/2021 10:21,3/13/2022 22:22
3061,2002-12-14,Thomasville,Montana,29634,610,610,0,8/18/2021 10:21,4/18/2022 12:56
3062,1964-09-20,Thomasville,Nebraska,29634,500,500,0,8/18/2021 10:32,1/22/2022 18:50
3063,2003-02-03,Thomasville,Nevada,29634,3140,3140,0,8/18/2021 10:41,5/7/2022 15:21
3064,2003-03-28,Thomasville,New Hampshire,29634,5490,5490,0,8/18/2021 11:09,4/18/2022 11:36
3065,1984-02-21,Thomasville,New Jersey,29634,870,1870,1000,8/18/2021 11:29,5/26/2022 21:14
3066,2002-06-13,Thomasville,New Mexico,29634,3280,3280,0,8/18/2021 11:32,5/3/2022 17:43
3067,1955-11-23,Thomasville,New York,29634,350,350,0,8/18/2021 11:43,2/26/2022 19:06
3068,2002-11-25,Thomasville,North Carolina,29634,2280,2280,0,8/18/2021 11:52,4/28/2022 10:08
3069,1979-05-11,Thomasville,North Dakota,29634,8175,8675,500,8/18/2021 11:54,5/3/2022 18:44
3070,2003-05-29,Thomasville,Ohio,29634,450,450,0,8/18/2021 11:55,11/13/2021 18:43
3071,1957-01-02,Thomasville,Oklahoma,29634,1010,1010,0,8/18/2021 11:55,4/16/2022 15:28
3072,2003-02-04,Thomasville,Oregon,29634,13575,13575,0,8/18/2021 11:56,7/1/2022 0:20
4,1990-04-16,Winston-Salem,North Carolina,27106,10790,14290,3500,8/18/2020 13:21,6/30/2022 22:22
3073,2004-10-20,Thomasville,Pennsylvania,29634,2270,2270,0,8/18/2021 12:03,4/18/2022 11:01
3074,1983-12-07,Thomasville,Rhode Island,29634,2100,2100,0,8/18/2021 12:04,3/25/2022 17:24
3075,1963-06-17,Thomasville,South Carolina,29634,830,1830,1000,8/18/2021 12:06,3/2/2022 20:55
3076,1959-08-23,Thomasville,South Dakota,29634,310,810,500,8/18/2021 12:15,4/18/2022 18:04
3077,2003-07-14,Thomasville,Tennessee,29634,2650,2650,0,8/18/2021 12:27,4/2/2022 21:32
3078,2002-09-11,Thomasville,Texas,29634,2070,2070,0,8/18/2021 12:42,4/16/2022 12:34
3079,1986-03-09,Thomasville,Utah,29634,6215,6215,0,8/18/2021 12:47,3/13/2022 22:15
3080,1993-08-17,Thomasville,Vermont,29634,0,9000,9000,8/18/2021 12:49,2/25/2022 15:00
3081,1953-01-11,Thomasville,Virginia,29634,15100,15100,0,8/18/2021 13:01,6/30/2022 20:12
3082,2003-02-15,Thomasville,Washington,29634,2810,2810,0,8/18/2021 15:04,4/13/2022 17:51
3083,1981-09-10,Thomasville,West Virginia,29634,300,300,0,8/18/2021 15:30,2/2/2022 15:56
3084,2003-03-17,Thomasville,Wisconsin,29634,1400,1400,0,8/18/2021 15:49,4/16/2022 17:30
3085,1967-07-05,Thomasville,Wyoming,29634,1130,1130,0,8/18/2021 16:20,5/2/2022 10:01
3086,1995-05-14,Thomasville,Alabama,29634,15735,15735,0,8/18/2021 16:21,7/1/2022 0:59
3087,2003-02-15,Thomasville,Alaska,29634,1785,9785,8000,8/18/2021 16:22,6/25/2022 21:22
3088,2003-05-11,Thomasville,Arizona,29634,1010,1010,0,8/18/2021 16:22,5/4/2022 9:18
3089,1998-10-06,Thomasville,Arkansas,29634,6630,6630,0,8/18/2021 16:25,6/22/2022 21:29
3090,1972-03-27,Thomasville,California,29634,2080,2080,0,8/18/2021 16:59,5/26/2022 20:06
3091,2003-07-31,Thomasville,Colorado,29634,2080,3080,1000,8/18/2021 17:11,4/8/2022 18:02
3092,2003-05-07,Thomasville,Connecticut,29634,300,800,500,8/18/2021 18:23,1/22/2022 20:04
3093,1978-05-16,Thomasville,Delaware,29634,1370,1370,0,8/18/2021 18:50,4/11/2022 12:06
3094,2003-09-12,Thomasville,District of Columbia,29634,1450,1450,0,8/18/2021 18:51,2/28/2022 14:41
3095,2003-01-30,Thomasville,Florida,29634,4560,5060,500,8/18/2021 19:06,6/30/2022 19:01
3096,1981-12-09,Thomasville,Georgia,29634,3190,3190,0,8/18/2021 19:24,6/3/2022 10:02
3097,2000-12-16,Thomasville,Hawaii,29634,1710,1710,0,8/18/2021 19:25,6/30/2022 15:26
3098,2003-05-10,Thomasville,Idaho,29634,1350,1350,0,8/18/2021 19:28,3/2/2022 19:45
3099,1979-07-04,Thomasville,Illinois,29634,300,300,0,8/18/2021 19:33,1/21/2022 0:15
3100,1952-10-16,Thomasville,Indiana,29634,2930,2930,0,8/18/2021 19:42,4/23/2022 1:11
3101,1982-08-05,Thomasville,Iowa,29634,1010,1010,0,8/18/2021 19:48,5/26/2022 20:06
3102,2002-12-05,Thomasville,Kansas,29634,12125,12125,0,8/18/2021 20:33,4/16/2022 12:07
3103,1988-07-07,Thomasville,Kentucky,29634,1400,1400,0,8/18/2021 20:34,3/14/2022 9:00
3104,1951-02-16,Thomasville,Louisiana,29634,3075,3075,0,8/18/2021 20:35,2/26/2022 18:48
3105,1974-05-04,Thomasville,Maine,29634,4860,4860,0,8/18/2021 20:36,5/7/2022 9:57
3106,1995-01-01,Thomasville,Maryland,29634,5050,5050,0,8/18/2021 20:36,6/30/2022 15:10
3107,2003-03-11,Thomasville,Massachusetts,29634,1000,1500,500,8/18/2021 20:52,1/12/2022 18:14
3108,1998-06-15,Thomasville,Michigan,29634,1060,1060,0,8/18/2021 23:00,5/2/2022 13:48
3109,1988-12-20,Thomasville,Minnesota,29634,2960,2960,0,8/18/2021 23:43,4/8/2022 18:04
3110,2003-05-13,Thomasville,Mississippi,29634,9425,9425,0,8/19/2021 0:24,4/16/2022 15:41
3111,2002-03-18,Thomasville,Missouri,29634,1010,1010,0,8/19/2021 8:09,4/15/2022 12:36
3112,2005-04-19,Thomasville,Montana,29634,450,1450,1000,8/19/2021 8:38,3/14/2022 11:00
3113,1992-01-16,Thomasville,Nebraska,29634,1870,1870,0,8/19/2021 9:20,4/14/2022 22:16
3114,1975-06-08,Thomasville,Nevada,29634,2470,2470,0,8/19/2021 9:25,4/19/2022 17:41
3115,1970-03-12,Thomasville,New Hampshire,29634,6120,6120,0,8/19/2021 9:33,5/2/2022 16:32
3116,1984-12-21,Thomasville,New Jersey,29634,12115,12115,0,8/19/2021 9:35,5/15/2022 22:52
3117,2003-08-10,Thomasville,New Mexico,29634,20465,20465,0,8/19/2021 9:37,6/26/2022 18:06
3118,1998-02-23,Thomasville,New York,29634,5200,5200,0,8/19/2021 9:40,4/15/2022 13:18
3119,1970-05-01,Thomasville,North Carolina,29634,800,800,0,8/19/2021 10:02,1/30/2022 18:26
3120,1994-01-17,Thomasville,North Dakota,29634,1700,1700,0,8/19/2021 10:02,3/16/2022 18:17
3121,1971-06-17,Thomasville,Ohio,29634,10675,10675,0,8/19/2021 10:08,5/27/2022 18:40
3122,2001-02-19,Thomasville,Oklahoma,29634,360,360,0,8/19/2021 10:22,5/21/2022 2:31
3123,1986-01-18,Thomasville,Oregon,29634,6680,6680,0,8/19/2021 10:30,4/8/2022 18:26
3124,1996-07-12,Thomasville,Pennsylvania,29634,3250,3250,0,8/19/2021 10:44,6/28/2022 20:19
3125,1993-10-10,Thomasville,Rhode Island,29634,1010,1010,0,8/19/2021 10:57,3/2/2022 9:29
3126,2003-01-01,Thomasville,South Carolina,29634,1410,1410,0,8/19/2021 11:08,4/16/2022 2:59
3127,1977-12-19,Thomasville,South Dakota,29634,1250,1750,500,8/19/2021 11:09,2/24/2022 19:06
3128,1995-08-18,Thomasville,Tennessee,29634,990,990,0,8/19/2021 11:11,5/11/2022 13:01
3129,1980-04-13,Thomasville,Texas,29634,1930,1930,0,8/19/2021 11:12,4/20/2022 18:56
3130,1983-05-28,Thomasville,Utah,29634,410,410,0,8/19/2021 11:12,5/1/2022 15:16
3131,2003-03-25,Thomasville,Vermont,29634,2030,2030,0,8/19/2021 11:14,5/3/2022 22:48
3132,2003-04-07,Thomasville,Virginia,29634,850,850,0,8/19/2021 11:17,1/12/2022 19:04
3133,1954-03-12,Thomasville,Washington,29634,720,720,0,8/19/2021 11:18,5/12/2022 14:04
3134,1955-07-09,Thomasville,West Virginia,29634,300,800,500,8/19/2021 11:19,1/12/2022 18:59
3135,1988-11-23,Thomasville,Wisconsin,29634,810,1310,500,8/19/2021 11:20,5/3/2022 0:12
3136,2002-11-04,Belmont ,Massachusetts,2478,1050,1550,500,8/19/2021 11:20,4/6/2022 13:09
3136,2002-11-04,Belmont ,Massachusetts,2478,1050,1550,500,8/19/2021 11:20,4/6/2022 13:09
3137,2001-09-18,Thomasville,Wyoming,29634,3270,3270,0,8/19/2021 11:25,5/15/2022 12:10
3138,2003-09-13,Thomasville,Alabama,29634,1905,1905,0,8/19/2021 11:37,1/31/2022 12:09
3139,1957-09-11,Thomasville,Alaska,29634,320,1320,1000,8/19/2021 11:39,4/15/2022 9:53
3140,2003-04-09,Dallas,Texas,75230,5700,6700,1000,8/19/2021 11:39,7/1/2022 0:02
3141,2003-05-21,Thomasville,Arizona,29634,1220,1720,500,8/19/2021 11:57,5/6/2022 17:23
3142,2003-01-27,Thomasville,Arkansas,29634,2400,2400,0,8/19/2021 11:59,1/12/2022 18:49
3143,1974-03-23,Thomasville,California,29634,900,900,0,8/19/2021 12:08,2/26/2022 18:17
3144,2003-11-29,Thomasville,Colorado,29634,4220,4220,0,8/19/2021 12:11,4/3/2022 10:36
3145,2003-03-31,Thomasville,Connecticut,29634,4915,4915,0,8/19/2021 12:21,5/21/2022 14:59
3146,2002-10-10,Thomasville,Delaware,29634,1200,1200,0,8/19/2021 12:23,3/15/2022 10:06
3147,1976-12-11,Thomasville,District of Columbia,29634,2920,2920,0,8/19/2021 12:27,4/3/2022 17:45
3148,1951-08-01,Thomasville,Florida,29634,870,870,0,8/19/2021 12:35,6/13/2022 11:08
3149,1985-04-01,Thomasville,Georgia,29634,1760,1760,0,8/19/2021 12:37,4/18/2022 18:01
3150,1980-01-20,Thomasville,Hawaii,29634,1460,1460,0,8/19/2021 12:37,3/13/2022 14:44
3151,1958-03-24,Thomasville,Idaho,29634,2980,2980,0,8/19/2021 12:42,3/25/2022 18:14
3152,1980-10-25,Thomasville,Illinois,29634,4840,4840,0,8/19/2021 12:43,4/27/2022 20:46
3153,2003-01-09,Thomasville,Indiana,29634,1250,1250,0,8/19/2021 12:44,3/13/2022 17:39
3154,1985-04-28,Thomasville,Iowa,29634,1890,1890,0,8/19/2021 12:50,6/20/2022 19:37
3155,1997-08-17,Thomasville,Kansas,29634,4870,4870,0,8/19/2021 12:56,4/18/2022 12:12
3156,2003-02-09,Thomasville,Kentucky,29634,3100,3100,0,8/19/2021 13:23,4/16/2022 17:33
3157,2003-02-26,Thomasville,Louisiana,29634,1150,1150,0,8/19/2021 13:26,11/30/2021 17:06
3158,1967-01-06,Thomasville,Maine,29634,1500,1500,0,8/19/2021 13:35,3/13/2022 17:39
3159,1978-03-16,Thomasville,Maryland,29634,1200,1700,500,8/19/2021 13:36,3/13/2022 17:49
3160,1988-10-01,Thomasville,Massachusetts,29634,5330,5330,0,8/19/2021 13:40,4/10/2022 17:48
3161,1978-07-05,Thomasville,Michigan,29634,2660,2660,0,8/19/2021 13:43,4/9/2022 14:46
3162,1960-08-12,Thomasville,Minnesota,29634,650,650,0,8/19/2021 13:52,3/16/2022 15:44
3163,1975-08-11,Thomasville,Mississippi,29634,5780,5780,0,8/19/2021 13:53,4/19/2022 18:58
3164,1953-12-12,Thomasville,Missouri,29634,1860,2360,500,8/19/2021 14:00,5/4/2022 12:01
3165,2003-05-25,Thomasville,Montana,29634,2790,2790,0,8/19/2021 14:07,6/22/2022 15:47
3166,2002-10-18,Thomasville,Nebraska,29634,4800,4800,0,8/19/2021 14:08,5/16/2022 16:14
3167,2003-02-12,Waxhaw,North Carolina,28173,1160,1160,0,8/19/2021 14:12,2/7/2022 21:01
3167,2003-02-12,Waxhaw,North Carolina,28173,1160,1160,0,8/19/2021 14:12,2/7/2022 21:01
3168,2002-12-12,Thomasville,Nevada,29634,1870,1870,0,8/19/2021 14:12,5/1/2022 15:14
3169,2003-09-20,Thomasville,New Hampshire,29634,1090,1090,0,8/19/2021 14:28,5/8/2022 15:49
3170,1998-01-19,Thomasville,New Jersey,29634,850,850,0,8/19/2021 14:30,3/2/2022 21:01
3171,2003-06-29,Thomasville,New Mexico,29634,450,450,0,8/19/2021 14:36,10/2/2021 10:28
3172,1998-02-02,Thomasville,New York,29634,820,820,0,8/19/2021 14:46,5/6/2022 12:45
3173,2003-01-05,Thomasville,North Carolina,29634,1600,1600,0,8/19/2021 14:50,1/28/2022 17:58
3174,2003-08-01,Thomasville,North Dakota,29634,1510,1510,0,8/19/2021 14:59,4/15/2022 14:04
3175,2002-11-08,Thomasville,Ohio,29634,2870,2870,0,8/19/2021 15:00,1/22/2022 16:56
3176,2003-04-25,Thomasville,Oklahoma,29634,1090,1090,0,8/19/2021 15:00,5/8/2022 9:21
3177,1997-07-23,Thomasville,Oregon,29634,2330,3330,1000,8/19/2021 15:00,6/30/2022 20:24
3178,2003-03-16,Thomasville,Pennsylvania,29634,3310,3310,0,8/19/2021 15:00,6/13/2022 23:01
3179,2003-06-27,Thomasville,Rhode Island,29634,3435,3435,0,8/19/2021 15:01,1/21/2022 17:28
3180,2002-11-29,Libertyville,Illinois,60048,3455,4455,1000,8/19/2021 15:02,5/4/2022 0:04
3181,1967-08-25,Thomasville,South Carolina,29634,750,750,0,8/19/2021 15:02,3/3/2022 1:00
3182,1993-11-14,Thomasville,South Dakota,29634,470,470,0,8/19/2021 15:22,4/11/2022 22:56
3183,1961-04-11,Thomasville,Tennessee,29634,1970,2470,500,8/19/2021 15:31,5/18/2022 4:31
3184,2002-12-30,Thomasville,Texas,29634,2090,2090,0,8/19/2021 15:39,6/30/2022 21:11
3185,2002-09-16,Thomasville,Utah,29634,2090,2090,0,8/19/2021 15:48,4/15/2022 20:42
3186,2001-12-21,Thomasville,Vermont,29634,920,920,0,8/19/2021 15:50,5/2/2022 10:01
3187,2001-04-24,Thomasville,Virginia,29634,1670,1670,0,8/19/2021 15:57,4/9/2022 18:22
3188,2002-11-18,Thomasville,Washington,29634,910,910,0,8/19/2021 16:02,4/18/2022 18:02
3189,1950-02-11,Thomasville,West Virginia,29634,350,850,500,8/19/2021 16:25,3/15/2022 16:42
3190,1999-12-17,Thomasville,Wisconsin,29634,770,770,0,8/19/2021 16:39,4/24/2022 11:32
3191,1998-08-12,Thomasville,Wyoming,29634,1000,1000,0,8/19/2021 16:39,2/26/2022 18:53
3192,1950-05-20,Thomasville,Alabama,29634,810,810,0,8/19/2021 16:39,4/11/2022 14:02
3193,1962-10-12,Thomasville,Alaska,29634,1660,1660,0,8/19/2021 16:44,4/10/2022 13:51
3194,1985-10-28,Thomasville,Arizona,29634,650,650,0,8/19/2021 16:47,9/18/2021 13:51
3195,2003-02-08,Thomasville,Arkansas,29634,1250,1250,0,8/19/2021 16:48,3/18/2022 7:19
3196,2003-02-04,Thomasville,California,29634,3310,3310,0,8/19/2021 16:51,3/6/2022 11:06
3197,1978-04-09,Thomasville,Colorado,29634,650,650,0,8/19/2021 16:57,2/26/2022 18:51
3198,1975-06-27,Thomasville,Connecticut,29634,920,1920,1000,8/19/2021 17:07,3/2/2022 11:29
3199,1999-04-16,Thomasville,Delaware,29634,460,960,500,8/19/2021 17:19,4/15/2022 17:30
3200,2003-01-14,Thomasville,District of Columbia,29634,1250,1250,0,8/19/2021 17:19,2/18/2022 13:00
3201,1956-10-02,Thomasville,Florida,29634,350,350,0,8/19/2021 17:22,3/11/2022 10:30
3202,1961-04-28,Thomasville,Georgia,29634,1320,1320,0,8/19/2021 17:26,3/9/2022 19:33
3203,2002-08-01,Weston,Massachusetts,2493,4990,6990,2000,8/19/2021 17:44,4/18/2022 10:58
3204,2002-07-17,Thomasville,Hawaii,29634,410,910,500,8/19/2021 17:47,6/3/2022 14:24
3205,1991-01-21,Thomasville,Idaho,29634,2330,2830,500,8/19/2021 18:00,3/2/2022 20:53
3206,2003-06-30,Thomasville,Illinois,29634,7290,7290,0,8/19/2021 18:07,4/19/2022 17:32
3207,1962-05-22,Thomasville,Indiana,29634,5010,5010,0,8/19/2021 18:09,5/3/2022 13:00
3208,1979-10-01,Thomasville,Iowa,29634,1330,1330,0,8/19/2021 18:13,4/29/2022 18:16
3209,2002-12-16,Thomasville,Kansas,29634,2860,2860,0,8/19/2021 18:14,4/12/2022 20:33
3210,2002-05-09,Thomasville,Kentucky,29634,5360,5360,0,8/19/2021 18:30,2/2/2022 19:44
3211,2003-06-23,Thomasville,Louisiana,29634,1440,1940,500,8/19/2021 18:32,2/26/2022 19:11
3212,1989-09-21,Thomasville,Maine,29634,3170,3170,0,8/19/2021 18:34,2/2/2022 19:20
3213,2003-03-15,Thomasville,Maryland,29634,7670,8170,500,8/19/2021 18:34,5/11/2022 13:01
3214,2003-02-08,Thomasville,Massachusetts,29634,2700,2700,0,8/19/2021 18:36,5/4/2022 12:03
3215,2003-03-28,Thomasville,Michigan,29634,3090,3090,0,8/19/2021 18:41,6/30/2022 19:43
3216,1954-09-18,Thomasville,Minnesota,29634,3960,3960,0,8/19/2021 18:48,4/18/2022 18:01
3217,1956-03-26,Thomasville,Mississippi,29634,2330,2330,0,8/19/2021 18:55,5/10/2022 17:15
3218,1987-11-27,Thomasville,Missouri,29634,910,910,0,8/19/2021 18:56,4/18/2022 10:58
3219,1993-10-12,Thomasville,Montana,29634,1600,1600,0,8/19/2021 18:57,3/2/2022 11:30
3220,2003-09-26,Thomasville,Nebraska,29634,850,850,0,8/19/2021 18:57,3/16/2022 3:19
3221,1982-10-10,Thomasville,Nevada,29634,1810,1810,0,8/19/2021 18:59,4/16/2022 18:05
3222,1966-03-16,Thomasville,New Hampshire,29634,700,700,0,8/19/2021 19:03,1/12/2022 18:53
3223,2003-07-19,Thomasville,New Jersey,29634,2160,2160,0,8/19/2021 19:03,1/22/2022 19:22
3224,2003-08-18,Thomasville,New Mexico,29634,5190,5190,0,8/19/2021 19:05,4/18/2022 18:01
3225,2000-03-28,Thomasville,New York,29634,5520,5520,0,8/19/2021 19:06,3/19/2022 16:22
3226,2002-08-23,Louisville,Kentucky,40222,5750,5750,0,8/19/2021 19:06,3/17/2022 10:03
3227,2003-03-27,Thomasville,North Carolina,29634,1460,1460,0,8/19/2021 19:13,4/13/2022 9:40
3228,1956-07-24,Thomasville,North Dakota,29634,3885,3885,0,8/19/2021 19:15,6/23/2022 9:41
3229,1987-03-03,Thomasville,Ohio,29634,1170,1170,0,8/19/2021 19:20,5/10/2022 18:05
3230,1958-04-15,Thomasville,Oklahoma,29634,6150,6150,0,8/19/2021 19:22,2/25/2022 9:15
3231,1982-02-05,Thomasville,Oregon,29634,1310,1810,500,8/19/2021 19:30,6/8/2022 22:26
3232,1953-04-22,Thomasville,Pennsylvania,29634,600,600,0,8/19/2021 19:37,3/14/2022 10:26
3233,2005-08-01,Thomasville,Rhode Island,29634,3230,3230,0,8/19/2021 19:40,3/8/2022 14:05
3234,2004-01-11,Thomasville,South Carolina,29634,1000,1000,0,8/19/2021 19:53,2/4/2022 14:51
3235,2002-11-08,Thomasville,South Dakota,29634,5815,5815,0,8/19/2021 19:53,5/26/2022 8:28
3236,1986-05-01,Thomasville,Tennessee,29634,9355,9355,0,8/19/2021 19:54,4/9/2022 18:03
3237,2002-10-26,Thomasville,Texas,29634,2430,2430,0,8/19/2021 20:04,4/23/2022 21:17
3238,2003-04-11,Nashville,Tennessee,37205,8090,8090,0,8/19/2021 20:05,4/18/2022 10:57
3239,1977-09-20,Thomasville,Utah,29634,2090,2090,0,8/19/2021 20:06,5/10/2022 18:56
3240,1958-01-08,Thomasville,Vermont,29634,1310,2310,1000,8/19/2021 20:10,6/4/2022 18:10
3241,1983-09-06,Thomasville,Virginia,29634,1550,1550,0,8/19/2021 20:12,2/26/2022 18:46
3242,2002-11-19,Thomasville,Washington,29634,3050,3050,0,8/19/2021 20:15,3/19/2022 15:29
3243,2004-11-20,Thomasville,West Virginia,29634,1630,1630,0,8/19/2021 20:15,7/1/2022 1:19
3244,2003-09-19,Thomasville,Wisconsin,29634,810,810,0,8/19/2021 20:16,1/22/2022 21:41
3245,2003-10-10,Thomasville,Wyoming,29634,8950,9450,500,8/19/2021 20:23,7/1/2022 8:25
3246,2003-07-09,Thomasville,Alabama,29634,530,1530,1000,8/19/2021 20:29,4/19/2022 12:51
3247,1972-08-11,Thomasville,Alaska,29634,1100,1100,0,8/19/2021 20:30,1/22/2022 21:56
3248,1995-05-11,Thomasville,Arizona,29634,4850,4850,0,8/19/2021 20:32,3/20/2022 10:32
3249,1954-07-11,Thomasville,Arkansas,29634,610,610,0,8/19/2021 20:43,3/2/2022 15:27
3250,1977-08-21,Thomasville,California,29634,450,450,0,8/19/2021 20:43,2/16/2022 8:25
3251,1970-02-11,Thomasville,Colorado,29634,450,450,0,8/19/2021 20:47,2/22/2022 10:57
3252,2005-04-27,Thomasville,Connecticut,29634,500,500,0,8/19/2021 20:49,3/26/2022 20:12
3253,1974-12-06,Thomasville,Delaware,29634,710,710,0,8/19/2021 21:01,4/10/2022 18:28
3254,2002-11-21,Thomasville,District of Columbia,29634,1550,1550,0,8/19/2021 23:01,1/22/2022 11:38
3255,1992-08-07,Thomasville,Florida,29634,350,350,0,8/19/2021 23:07,1/17/2022 17:06
3256,1968-03-25,Thomasville,Georgia,29634,450,450,0,8/19/2021 23:14,4/2/2022 15:22
3257,1989-04-23,Thomasville,Hawaii,29634,3440,3440,0,8/19/2021 23:19,3/19/2022 16:20
3258,2003-07-17,Thomasville,Idaho,29634,1510,1510,0,8/20/2021 8:06,3/25/2022 14:07
3259,2002-11-19,Thomasville,Illinois,29634,690,1690,1000,8/20/2021 8:24,2/26/2022 11:56
3260,1995-03-07,Thomasville,Indiana,29634,1650,1650,0,8/20/2021 9:13,4/3/2022 12:43
3261,2003-01-03,Thomasville,Iowa,29634,5020,5520,500,8/20/2021 9:40,4/16/2022 13:38
3262,1976-09-20,Thomasville,Kansas,29634,760,760,0,8/20/2021 9:44,4/13/2022 9:34
3263,2002-10-22,Thomasville,Kentucky,29634,6070,6070,0,8/20/2021 9:56,4/9/2022 17:34
3264,1968-05-21,Thomasville,Louisiana,29634,2720,2720,0,8/20/2021 11:30,6/30/2022 17:07
3265,2003-01-17,Thomasville,Maine,29634,400,400,0,8/20/2021 12:32,1/22/2022 20:00
3266,1969-10-17,Thomasville,Maryland,29634,300,300,0,8/20/2021 12:36,3/2/2022 13:07
3267,2003-02-17,Gainesville,Florida,32608,1540,1540,0,8/20/2021 12:41,1/21/2022 17:41
3268,2003-07-22,Thomasville,Massachusetts,29634,2990,2990,0,8/20/2021 12:48,4/13/2022 10:59
3269,1964-08-09,Thomasville,Michigan,29634,1965,1965,0,8/20/2021 12:56,3/4/2022 22:22
3270,2003-02-06,Thomasville,Minnesota,29634,1020,1020,0,8/20/2021 13:05,5/11/2022 13:05
3271,2003-09-05,Thomasville,Mississippi,29634,2150,2150,0,8/20/2021 13:19,3/18/2022 6:45
3272,2003-01-31,Thomasville,Missouri,29634,2350,8350,6000,8/20/2021 13:23,7/1/2022 7:55
3273,1993-01-25,Thomasville,Montana,29634,600,600,0,8/20/2021 13:48,3/19/2022 15:39
3274,1969-03-23,Thomasville,Nebraska,29634,1770,1770,0,8/20/2021 13:49,3/6/2022 12:39
3275,1971-05-28,Thomasville,Nevada,29634,1590,3590,2000,8/20/2021 13:51,3/30/2022 12:02
3276,2002-06-11,Thomasville,New Hampshire,29634,1840,2340,500,8/20/2021 13:52,5/4/2022 9:10
3277,1982-02-13,Thomasville,New Jersey,29634,2720,2720,0,8/20/2021 14:01,5/6/2022 15:07
3278,1961-12-22,Thomasville,New Mexico,29634,1550,1550,0,8/20/2021 14:26,3/15/2022 20:04
3279,1952-04-05,Thomasville,New York,29634,650,650,0,8/20/2021 14:30,2/27/2022 16:02
3280,1995-12-13,Thomasville,North Carolina,29634,300,300,0,8/20/2021 14:33,10/30/2021 14:51
3281,2003-02-02,Thomasville,North Dakota,29634,1100,1100,0,8/20/2021 14:46,1/12/2022 15:00
3282,2002-11-19,Thomasville,Ohio,29634,1290,1290,0,8/20/2021 15:53,4/8/2022 21:52
3283,2001-11-28,Thomasville,Oklahoma,29634,1500,1500,0,8/20/2021 16:49,11/23/2021 10:01
3284,2001-01-07,Thomasville,Oregon,29634,1210,1710,500,8/20/2021 16:51,4/10/2022 13:16
3285,1997-10-26,Thomasville,Pennsylvania,29634,5670,5670,0,8/20/2021 17:05,4/12/2022 22:39
3286,2003-06-27,Thomasville,Rhode Island,29634,4120,4120,0,8/20/2021 17:10,2/2/2022 16:33
3287,1960-05-10,Thomasville,South Carolina,29634,300,300,0,8/20/2021 17:35,2/21/2022 17:19
3288,1957-07-19,Thomasville,South Dakota,29634,1600,2000,400,8/20/2021 17:53,2/19/2022 11:56
3289,1971-03-21,Thomasville,Tennessee,29634,300,300,0,8/20/2021 18:12,1/11/2022 23:30
3290,1991-03-20,Thomasville,Texas,29634,730,730,0,8/20/2021 18:13,4/8/2022 19:16
3291,2001-01-11,Thomasville,Utah,29634,4560,4560,0,8/20/2021 18:23,5/24/2022 19:31
3292,1963-10-01,Thomasville,Vermont,29634,550,550,0,8/20/2021 18:35,2/26/2022 18:50
3293,2003-08-20,Thomasville,Virginia,29634,300,300,0,8/20/2021 18:36,1/16/2022 13:27
3294,1991-06-08,Thomasville,Washington,29634,0,1000,1000,8/20/2021 18:36,1/22/2022 19:00
3295,2003-07-03,Thomasville,West Virginia,29634,4710,4710,0,8/20/2021 18:40,6/30/2022 16:48
3296,2021-08-21,Thomasville,Wisconsin,29634,1810,1810,0,8/20/2021 18:52,2/25/2022 14:57
3297,1975-02-12,Thomasville,Wyoming,29634,350,350,0,8/20/2021 19:39,4/2/2022 17:13
3298,2003-04-11,Thomasville,Alabama,29634,4620,4620,0,8/20/2021 20:40,5/30/2022 0:16
3299,2002-07-31,Thomasville,Alaska,29634,2260,2260,0,8/20/2021 20:46,2/19/2022 12:24
3300,1981-03-18,Thomasville,Arizona,29634,350,350,0,8/20/2021 20:48,2/28/2022 15:31
3301,1987-10-24,Thomasville,Arkansas,29634,2290,2290,0,8/20/2021 20:51,4/16/2022 16:21
3302,1989-11-04,Thomasville,California,29634,2440,2440,0,8/20/2021 21:12,5/6/2022 19:00
3303,1953-11-24,Thomasville,Colorado,29634,300,300,0,8/20/2021 21:25,3/18/2022 17:18
3304,1962-02-13,Thomasville,Connecticut,29634,650,1650,1000,8/20/2021 21:44,2/26/2022 18:37
3305,2002-11-22,Thomasville,Delaware,29634,2180,2180,0,8/20/2021 22:35,4/10/2022 16:05
3306,2003-02-16,Thomasville,District of Columbia,29634,1160,1160,0,8/20/2021 22:35,2/18/2022 0:47
3307,1961-10-28,Thomasville,Florida,29634,810,810,0,8/20/2021 22:54,4/24/2022 11:55
3308,2002-12-12,Thomasville,Georgia,29634,400,400,0,8/20/2021 23:09,2/12/2022 10:52
3309,1971-04-02,Thomasville,Hawaii,29634,300,300,0,8/20/2021 23:10,1/12/2022 19:10
3310,2003-05-14,Thomasville,Idaho,29634,6590,6590,0,8/20/2021 23:11,6/17/2022 12:42
3311,1972-12-23,Thomasville,Illinois,29634,350,350,0,8/21/2021 0:19,3/1/2022 16:47
3312,1957-11-19,Thomasville,Indiana,29634,1310,1810,500,8/21/2021 0:45,1/22/2022 19:58
3313,2004-03-10,Thomasville,Iowa,29634,2050,2050,0,8/21/2021 9:47,1/22/2022 13:38
3314,2004-05-14,Thomasville,Kansas,29634,1600,1600,0,8/21/2021 10:28,3/19/2022 19:32
3315,1972-11-20,Thomasville,Kentucky,29634,5540,5540,0,8/21/2021 10:30,4/19/2022 19:17
3316,1968-07-19,Thomasville,Louisiana,29634,750,750,0,8/21/2021 10:41,4/5/2022 14:05
3317,1983-12-01,Thomasville,Maine,29634,3280,3280,0,8/21/2021 10:46,3/1/2022 21:38
3318,1978-08-09,Potomac,Maryland,20854,6380,6380,0,8/21/2021 11:09,5/11/2022 14:42
3319,1967-08-28,Thomasville,Maryland,29634,1560,1560,0,8/21/2021 11:30,2/12/2022 9:32
3320,1978-07-22,Thomasville,Massachusetts,29634,520,520,0,8/21/2021 11:38,6/24/2022 21:07
3321,1974-04-01,Thomasville,Michigan,29634,1010,1010,0,8/21/2021 12:13,11/26/2021 17:26
3322,1956-06-19,Thomasville,Minnesota,29634,750,750,0,8/21/2021 12:23,1/12/2022 18:14
3323,1987-01-13,Thomasville,Mississippi,29634,2060,2060,0,8/21/2021 12:25,2/21/2022 11:25
3324,1958-08-04,Thomasville,Missouri,29634,8170,8170,0,8/21/2021 12:37,5/4/2022 19:21
3325,2003-09-28,Thomasville,Montana,29634,4400,4400,0,8/21/2021 12:43,2/25/2022 20:15
3326,2003-09-26,Thomasville,Nebraska,29634,2930,4930,2000,8/21/2021 12:44,4/19/2022 17:04
3327,2003-02-06,Thomasville,Nevada,29634,3060,3060,0,8/21/2021 12:56,5/21/2022 22:15
3328,2003-10-06,Thomasville,New Hampshire,29634,2700,2700,0,8/21/2021 13:01,3/31/2022 19:04
3329,1955-04-08,Thomasville,New Jersey,29634,6940,6940,0,8/21/2021 13:01,5/9/2022 18:09
3330,1971-11-25,Thomasville,New Mexico,29634,1885,1885,0,8/21/2021 13:08,4/18/2022 21:40
3331,2003-05-02,Thomasville,New York,29634,2435,2435,0,8/21/2021 13:08,5/2/2022 10:02
3332,2003-06-12,Thomasville,North Carolina,29634,2235,2235,0,8/21/2021 13:09,5/3/2022 20:41
3333,2003-02-28,Thomasville,North Dakota,29634,7525,7525,0,8/21/2021 13:26,5/7/2022 11:16
3334,1954-11-09,Thomasville,Ohio,29634,300,300,0,8/21/2021 13:27,3/29/2022 16:08
3335,1995-02-25,Thomasville,Oklahoma,29634,490,490,0,8/21/2021 13:29,5/27/2022 15:01
3336,1969-10-14,Thomasville,Oregon,29634,810,810,0,8/21/2021 13:30,4/10/2022 9:27
3337,1982-10-13,Thomasville,Pennsylvania,29634,280,780,500,8/21/2021 13:32,4/27/2022 3:16
3338,2002-09-24,Thomasville,Rhode Island,29634,400,400,0,8/21/2021 13:33,3/17/2022 10:08
3339,1990-11-13,Thomasville,South Carolina,29634,1250,1250,0,8/21/2021 13:42,3/10/2022 22:48
3340,1965-03-15,Thomasville,South Dakota,29634,2110,2110,0,8/21/2021 13:43,2/26/2022 18:46
3341,1955-01-22,Thomasville,Tennessee,29634,3850,3850,0,8/21/2021 13:44,5/7/2022 14:16
3342,2004-03-17,Thomasville,Texas,29634,850,850,0,8/21/2021 13:51,3/9/2022 11:13
3343,2004-04-13,Thomasville,Utah,29634,2470,2470,0,8/21/2021 13:53,5/26/2022 20:06
3344,1974-11-19,Thomasville,Vermont,29634,230,730,500,8/21/2021 14:25,6/30/2022 13:10
3345,2002-10-29,Thomasville,Virginia,29634,3960,4460,500,8/21/2021 14:32,5/2/2022 18:00
3346,2002-07-26,Thomasville,Washington,29634,10575,10575,0,8/21/2021 15:40,5/1/2022 13:10
3347,1984-10-13,Thomasville,West Virginia,29634,5830,5830,0,8/21/2021 15:47,5/12/2022 13:10
3348,1958-06-17,Thomasville,Wisconsin,29634,1010,1010,0,8/21/2021 16:12,4/16/2022 13:55
3349,2002-10-31,Thomasville,Wyoming,29634,1520,1520,0,8/21/2021 16:14,5/20/2022 14:59
3350,2003-03-08,Winston-Salem,North Carolina,27109,3560,3560,0,8/21/2021 16:19,4/18/2022 12:13
3350,2003-03-08,Winston-Salem,North Carolina,27109,3560,3560,0,8/21/2021 16:19,4/18/2022 12:13
3351,2003-10-17,Thomasville,Alabama,29634,3435,3435,0,8/21/2021 16:26,5/3/2022 13:01
3352,1955-12-09,Thomasville,Alaska,29634,2390,2390,0,8/21/2021 16:27,3/2/2022 15:34
3353,1955-02-22,Thomasville,Arizona,29634,4370,4370,0,8/21/2021 16:40,4/8/2022 20:06
3354,1993-01-03,Thomasville,Arkansas,29634,700,700,0,8/21/2021 16:43,3/15/2022 10:46
3355,1963-11-09,Thomasville,California,29634,4860,4860,0,8/21/2021 17:04,4/10/2022 9:41
3356,1986-12-12,Thomasville,Colorado,29634,1980,1980,0,8/21/2021 17:05,4/30/2022 22:55
3357,2003-02-17,Thomasville,Connecticut,29634,2000,2000,0,8/21/2021 17:05,3/22/2022 11:44
3358,1999-01-05,Thomasville,Delaware,29634,1160,1160,0,8/21/2021 17:05,4/22/2022 20:41
3359,1991-11-09,Thomasville,District of Columbia,29634,1450,1450,0,8/21/2021 17:25,4/19/2022 12:00
3360,2003-07-28,Thomasville,Florida,29634,660,660,0,8/21/2021 17:41,4/19/2022 17:32
3361,2003-02-06,Nashville,Tennessee,37204,5280,5280,0,8/21/2021 17:45,7/1/2022 6:49
3362,1988-08-23,Thomasville,Georgia,29634,550,1050,500,8/21/2021 17:52,1/18/2022 22:06
3363,1992-02-05,Thomasville,Hawaii,29634,1630,1630,0,8/21/2021 17:53,2/25/2022 18:47
3364,1975-08-25,Thomasville,Idaho,29634,610,1110,500,8/21/2021 17:54,4/8/2022 12:16
3365,1989-06-24,Thomasville,Illinois,29634,2390,2390,0,8/21/2021 17:54,5/4/2022 14:37
3366,2001-06-17,Thomasville,Indiana,29634,1180,1180,0,8/21/2021 17:54,4/20/2022 23:28
3367,1959-11-06,Thomasville,Iowa,29634,310,310,0,8/21/2021 17:54,4/10/2022 20:22
3368,1984-06-25,Thomasville,Kansas,29634,700,700,0,8/21/2021 17:56,3/27/2022 0:03
3369,1985-01-19,Thomasville,Kentucky,29634,1320,1320,0,8/21/2021 17:58,6/30/2022 8:29
3370,1984-06-17,Thomasville,Louisiana,29634,2800,2800,0,8/21/2021 17:59,4/15/2022 16:50
3371,1996-04-16,Thomasville,Maine,29634,2560,2560,0,8/21/2021 18:00,3/8/2022 12:07
3372,1972-12-05,Thomasville,Maryland,29634,3855,3855,0,8/21/2021 18:01,6/30/2022 20:40
3373,2002-11-11,Thomasville,Massachusetts,29634,9965,9965,0,8/21/2021 18:07,4/9/2022 14:45
3374,2003-01-08,Thomasville,Michigan,29634,1360,1360,0,8/21/2021 18:14,1/21/2022 16:14
3375,1979-04-22,Thomasville,Minnesota,29634,1910,1910,0,8/21/2021 18:14,5/9/2022 18:03
3376,1979-05-14,Thomasville,Mississippi,29634,1930,1930,0,8/21/2021 18:21,4/27/2022 9:17
3377,2003-08-22,Thomasville,Missouri,29634,1300,1300,0,8/21/2021 18:22,2/1/2022 13:41
3378,2003-07-10,Thomasville,Montana,29634,8035,10035,2000,8/21/2021 18:23,5/6/2022 11:53
3379,1958-10-06,Thomasville,Nebraska,29634,400,400,0,8/21/2021 18:24,3/25/2022 17:01
3380,1976-02-16,Thomasville,Nevada,29634,650,650,0,8/21/2021 18:27,2/26/2022 19:19
3381,1999-02-15,Thomasville,New Hampshire,29634,1150,1150,0,8/21/2021 18:27,2/16/2022 18:30
3382,1970-02-28,Thomasville,New Jersey,29634,2000,3000,1000,8/21/2021 18:27,3/24/2022 18:32
3383,1983-05-26,Thomasville,New Mexico,29634,2410,2410,0,8/21/2021 18:28,4/15/2022 20:55
3384,2003-08-26,Thomasville,New York,29634,2350,2350,0,8/21/2021 18:30,4/30/2022 9:23
3385,1977-01-03,Thomasville,North Carolina,29634,950,950,0,8/21/2021 18:32,5/4/2022 21:38
3386,1971-05-04,Thomasville,North Dakota,29634,1800,1800,0,8/21/2021 18:32,3/25/2022 19:09
3387,2002-11-05,Thomasville,Ohio,29634,2610,2610,0,8/21/2021 18:32,3/2/2022 21:43
3388,1958-09-23,Thomasville,Oklahoma,29634,1610,1610,0,8/21/2021 18:35,5/10/2022 18:46
3389,2003-06-30,Thomasville,Oregon,29634,1750,1750,0,8/21/2021 18:35,1/23/2022 21:18
3390,2002-12-06,Thomasville,Pennsylvania,29634,4610,4610,0,8/21/2021 18:37,7/1/2022 6:37
3391,2003-04-23,Thomasville,Rhode Island,29634,2760,2760,0,8/21/2021 18:37,3/25/2022 17:57
3392,1985-09-11,Thomasville,South Carolina,29634,1430,1430,0,8/21/2021 18:39,5/7/2022 18:22
3393,1962-04-11,Thomasville,South Dakota,29634,450,450,0,8/21/2021 18:40,1/22/2022 11:55
3394,2003-07-02,Thomasville,Tennessee,29634,5835,5835,0,8/21/2021 18:42,6/9/2022 10:40
3395,1991-02-08,Thomasville,Texas,29634,2730,2730,0,8/21/2021 18:42,4/25/2022 15:53
3396,2003-06-19,Westport,Connecticut,6880,4155,4655,500,8/21/2021 18:43,5/10/2022 16:43
3397,1953-08-09,Thomasville,Utah,29634,1760,1760,0,8/21/2021 18:43,3/15/2022 17:21
3398,1990-12-20,Thomasville,Vermont,29634,2470,3470,1000,8/21/2021 18:44,5/31/2022 15:03
3399,1985-01-08,Thomasville,Virginia,29634,350,350,0,8/21/2021 18:44,2/22/2022 10:03
3400,1969-05-12,Thomasville,Washington,29634,1970,1970,0,8/21/2021 18:45,5/7/2022 16:11
3401,1973-11-10,Thomasville,West Virginia,29634,900,900,0,8/21/2021 18:45,2/27/2022 16:00
3402,1979-10-21,Thomasville,Wisconsin,29634,5780,5780,0,8/21/2021 18:45,5/28/2022 10:50
3403,2002-11-23,Thomasville,Wyoming,29634,6130,6630,500,8/21/2021 18:45,5/2/2022 18:06
3404,2002-01-28,Westport,Connecticut,6880,4895,5395,500,8/21/2021 18:45,5/11/2022 0:22
3405,1964-03-09,Thomasville,Alabama,29634,470,970,500,8/21/2021 18:46,1/20/2022 17:23
3406,1994-08-05,Thomasville,Alaska,29634,350,350,0,8/21/2021 18:46,2/1/2022 15:51
3407,1982-08-01,Thomasville,Arizona,29634,1100,1100,0,8/21/2021 18:47,3/22/2022 10:45
3408,1993-05-15,Thomasville,Arkansas,29634,860,860,0,8/21/2021 18:47,4/14/2022 11:03
3409,1972-04-10,Thomasville,California,29634,2150,2150,0,8/21/2021 18:48,4/1/2022 14:42
3410,2001-10-25,Thomasville,Colorado,29634,510,510,0,8/21/2021 18:48,2/3/2022 12:07
3411,2001-09-08,Thomasville,Connecticut,29634,1270,1770,500,8/21/2021 18:49,3/24/2022 18:33
3412,1952-10-02,Thomasville,Delaware,29634,960,1460,500,8/21/2021 18:49,4/26/2022 19:32
3413,1993-06-26,Thomasville,District of Columbia,29634,600,600,0,8/21/2021 18:50,3/6/2022 17:52
3414,1989-02-22,Thomasville,Florida,29634,1860,1860,0,8/21/2021 18:50,6/30/2022 18:30
3415,1962-02-20,Thomasville,Georgia,29634,600,600,0,8/21/2021 18:50,1/21/2022 18:58
3416,1993-11-04,Thomasville,Hawaii,29634,800,800,0,8/21/2021 18:50,11/13/2021 10:51
3417,2003-04-30,Thomasville,Idaho,29634,4410,4410,0,8/21/2021 18:51,4/15/2022 20:47
3418,1979-05-07,Thomasville,Illinois,29634,7905,7905,0,8/21/2021 18:51,5/3/2022 20:56
3419,1955-09-20,Thomasville,Indiana,29634,1820,1820,0,8/21/2021 18:56,3/11/2022 23:26
3420,1951-11-01,Thomasville,Iowa,29634,2770,2770,0,8/21/2021 18:58,6/25/2022 1:57
3421,2002-11-04,Thomasville,Kansas,29634,8110,8110,0,8/21/2021 18:59,6/30/2022 16:10
3422,2002-12-14,Thomasville,Kentucky,29634,12325,13325,1000,8/21/2021 19:00,4/19/2022 16:02
3423,2003-05-28,Thomasville,Louisiana,29634,6670,6670,0,8/21/2021 19:00,4/2/2022 18:22
3424,1985-01-20,Thomasville,Maine,29634,960,960,0,8/21/2021 19:03,4/8/2022 9:14
3425,1982-10-12,Thomasville,Maryland,29634,1080,1580,500,8/21/2021 19:04,2/25/2022 22:23
3426,1954-02-12,Thomasville,Massachusetts,29634,760,760,0,8/21/2021 19:04,10/30/2021 14:50
3427,1999-08-27,Thomasville,Michigan,29634,610,1110,500,8/21/2021 19:04,2/18/2022 13:56
3428,1997-08-18,Thomasville,Minnesota,29634,710,710,0,8/21/2021 19:05,4/10/2022 22:24
3429,1996-11-15,Thomasville,Mississippi,29634,1010,1010,0,8/21/2021 19:05,6/18/2022 15:49
3430,1977-08-15,Thomasville,Missouri,29634,330,330,0,8/21/2021 19:07,5/22/2022 19:04
3431,2003-02-12,Thomasville,Montana,29634,2800,2800,0,8/21/2021 19:10,5/18/2022 18:22
3432,1978-07-16,Thomasville,Nebraska,29634,1060,1060,0,8/21/2021 19:15,1/13/2022 13:55
3433,2002-11-22,Thomasville,Nevada,29634,1380,1380,0,8/21/2021 19:15,2/26/2022 13:53
3434,2003-04-07,Jamesville,New York,13078,1200,1200,0,8/21/2021 19:19,2/22/2022 9:54
3435,1994-01-23,Thomasville,New Hampshire,29634,450,450,0,8/21/2021 19:19,1/12/2022 19:05
3436,1960-01-28,Thomasville,New Jersey,29634,900,900,0,8/21/2021 19:20,2/24/2022 20:25
3437,1985-01-25,Thomasville,New Mexico,29634,1615,1615,0,8/21/2021 19:22,5/25/2022 17:20
3438,1970-11-07,Thomasville,New York,29634,1490,1490,0,8/21/2021 19:22,4/9/2022 13:51
3439,2003-05-28,Thomasville,North Carolina,29634,1210,1210,0,8/21/2021 19:22,2/23/2022 22:14
3440,1999-07-01,Thomasville,North Dakota,29634,975,2975,2000,8/21/2021 19:23,6/16/2022 13:00
3441,2001-08-26,Thomasville,Ohio,29634,4860,4860,0,8/21/2021 19:23,12/4/2021 20:41
3442,1979-10-01,Thomasville,Oklahoma,29634,4290,4790,500,8/21/2021 19:24,2/16/2022 11:27
3443,1989-02-16,Thomasville,Oregon,29634,4330,4330,0,8/21/2021 19:24,3/19/2022 15:42
3444,2001-10-25,Thomasville,Pennsylvania,29634,610,610,0,8/21/2021 19:24,3/7/2022 18:00
3445,2002-07-03,Thomasville,Rhode Island,29634,960,1460,500,8/21/2021 19:25,5/16/2022 18:12
3446,2000-01-12,Thomasville,South Carolina,29634,550,550,0,8/21/2021 19:30,2/12/2022 15:06
3447,1968-04-25,Thomasville,South Dakota,29634,1575,1575,0,8/21/2021 19:31,6/16/2022 15:20
3448,2003-01-26,Thomasville,Tennessee,29634,750,750,0,8/21/2021 19:32,3/2/2022 16:41
3449,1961-08-16,Thomasville,Texas,29634,850,1350,500,8/21/2021 19:33,2/26/2022 18:57
3450,1980-05-02,Thomasville,Utah,29634,2140,2140,0,8/21/2021 19:34,1/20/2022 22:05
3451,2002-07-10,Weston,Massachusetts,2493,2410,2410,0,8/21/2021 19:34,6/24/2022 14:54
3452,1991-05-19,Thomasville,Vermont,29634,410,410,0,8/21/2021 19:34,1/18/2022 20:16
3453,2003-05-05,Memphis,Tennessee,38112,4230,4230,0,8/21/2021 19:41,4/18/2022 10:57
3454,1985-10-01,Thomasville,Virginia,29634,700,700,0,8/21/2021 19:46,3/12/2022 10:45
3455,1969-01-13,Thomasville,Washington,29634,510,1010,500,8/21/2021 19:52,4/8/2022 18:57
3456,1984-05-13,Thomasville,West Virginia,29634,1770,1770,0,8/21/2021 19:55,5/11/2022 13:01
3457,1971-08-19,Thomasville,Wisconsin,29634,2560,2560,0,8/21/2021 19:55,6/9/2022 9:07
3458,2003-05-30,Thomasville,Wyoming,29634,1730,1730,0,8/21/2021 19:58,4/8/2022 12:44
3459,1957-12-15,Thomasville,Alabama,29634,850,850,0,8/21/2021 19:58,1/29/2022 13:02
3460,1998-05-22,Thomasville,Alaska,29634,3775,3775,0,8/21/2021 20:00,3/2/2022 17:17
3461,2005-08-12,Thomasville,Arizona,29634,1500,1500,0,8/21/2021 20:00,1/12/2022 18:57
3462,1995-06-20,Thomasville,Arkansas,29634,1500,1500,0,8/21/2021 20:01,2/26/2022 17:25
3463,1962-04-21,Thomasville,California,29634,470,1470,1000,8/21/2021 20:01,4/8/2022 15:30
3464,1957-04-06,Thomasville,Colorado,29634,15760,15760,0,8/21/2021 20:01,4/4/2022 22:03
3465,2002-11-11,Thomasville,Connecticut,29634,5790,5790,0,8/21/2021 20:01,6/4/2022 8:49
3466,2003-01-30,Thomasville,Delaware,29634,1380,1380,0,8/21/2021 20:02,4/16/2022 9:11
3467,1961-01-23,Thomasville,District of Columbia,29634,1750,1750,0,8/21/2021 20:02,3/27/2022 20:13
3468,2002-12-06,Thomasville,Florida,29634,6170,6170,0,8/21/2021 20:02,4/12/2022 14:17
3469,1955-02-01,Thomasville,Georgia,29634,1160,1160,0,8/21/2021 20:03,5/3/2022 15:11
3470,2003-05-01,Thomasville,Hawaii,29634,2500,2500,0,8/21/2021 20:03,1/26/2022 16:42
3471,2001-03-05,Thomasville,Idaho,29634,1350,1850,500,8/21/2021 20:04,2/26/2022 18:06
3472,1953-08-06,Thomasville,Illinois,29634,1240,1240,0,8/21/2021 20:05,6/28/2022 12:13
3473,1951-06-11,Thomasville,Indiana,29634,310,310,0,8/21/2021 20:07,3/1/2022 15:21
3474,1980-04-04,Thomasville,Iowa,29634,3350,4350,1000,8/21/2021 20:07,3/2/2022 20:54
3475,1994-11-21,Thomasville,Kansas,29634,960,960,0,8/21/2021 20:07,4/16/2022 11:16
3476,1979-12-18,Thomasville,Kentucky,29634,2270,2270,0,8/21/2021 20:10,4/8/2022 15:25
3477,2002-12-06,Thomasville,Louisiana,29634,1970,1970,0,8/21/2021 20:11,5/16/2022 1:10
3478,1990-09-11,Thomasville,Maine,29634,640,640,0,8/21/2021 20:20,4/15/2022 11:56
3479,2000-07-02,Thomasville,Maryland,29634,1100,1100,0,8/21/2021 20:23,6/12/2022 19:16
3480,1997-11-27,Thomasville,Massachusetts,29634,4180,4180,0,8/21/2021 20:27,6/30/2022 18:31
3481,1970-11-07,Thomasville,Michigan,29634,1770,1770,0,8/21/2021 20:33,5/4/2022 9:04
3482,2002-02-13,Thomasville,Minnesota,29634,3010,3010,0,8/21/2021 20:34,4/16/2022 16:02
3483,2002-04-17,Thomasville,Mississippi,29634,460,460,0,8/21/2021 20:35,3/29/2022 16:04
3484,1993-09-21,Thomasville,Missouri,29634,4410,4410,0,8/21/2021 20:36,5/3/2022 20:12
3485,1986-06-09,Thomasville,Montana,29634,5110,5110,0,8/21/2021 20:37,6/10/2022 23:24
3486,1990-03-03,Thomasville,Nebraska,29634,2400,2400,0,8/21/2021 20:38,3/2/2022 21:01
3487,1978-08-01,Thomasville,Nevada,29634,790,790,0,8/21/2021 20:38,5/4/2022 12:13
3488,1962-10-26,Thomasville,New Hampshire,29634,500,1000,500,8/21/2021 20:39,3/13/2022 10:39
3489,2002-12-19,Thomasville,New Jersey,29634,9850,9850,0,8/21/2021 20:42,4/15/2022 13:10
3490,2001-09-09,Thomasville,New Mexico,29634,1290,1290,0,8/21/2021 20:45,6/18/2022 14:36
3491,1990-07-26,Thomasville,New York,29634,1650,1650,0,8/21/2021 20:47,3/3/2022 16:33
3492,1983-04-14,Thomasville,North Carolina,29634,3000,3000,0,8/21/2021 20:56,3/15/2022 11:32
3493,1999-10-25,Thomasville,North Dakota,29634,2790,2790,0,8/21/2021 21:00,4/21/2022 12:51
3494,1993-02-24,Thomasville,Ohio,29634,7730,7730,0,8/21/2021 21:01,6/22/2022 22:22
3495,2002-10-23,Thomasville,Oklahoma,29634,2220,2220,0,8/21/2021 21:03,4/9/2022 10:16
3496,1955-11-20,Thomasville,Oregon,29634,2060,2060,0,8/21/2021 21:03,4/7/2022 22:10
3497,1974-07-10,Thomasville,Pennsylvania,29634,2150,2150,0,8/21/2021 21:12,3/23/2022 18:14
3498,1964-09-14,Thomasville,Rhode Island,29634,1450,1450,0,8/21/2021 21:12,11/13/2021 20:04
3499,2002-10-30,Thomasville,South Carolina,29634,3450,3450,0,8/21/2021 21:47,5/10/2022 18:03
3500,1954-04-27,Thomasville,South Dakota,29634,2870,2870,0,8/21/2021 23:49,4/12/2022 16:56
3501,1984-03-04,Thomasville,Tennessee,29634,1130,1130,0,8/22/2021 1:25,4/24/2022 11:32
3502,1989-09-17,Thomasville,Texas,29634,570,570,0,8/22/2021 7:54,4/18/2022 10:57
3503,2005-04-15,Thomasville,Utah,29634,1750,2250,500,8/22/2021 9:15,3/14/2022 9:01
3504,1994-01-05,Thomasville,Vermont,29634,2440,2440,0,8/22/2021 9:44,4/18/2022 11:03
3505,1987-01-23,Thomasville,Virginia,29634,600,600,0,8/22/2021 11:01,3/22/2022 9:57
3506,2002-04-16,Thomasville,Washington,29634,650,650,0,8/22/2021 11:05,3/10/2022 11:16
3507,1967-03-26,Thomasville,West Virginia,29634,900,900,0,8/22/2021 11:11,2/28/2022 21:11
3508,2003-02-18,Thomasville,Wisconsin,29634,4440,4440,0,8/22/2021 11:14,4/16/2022 13:21
3509,1962-09-15,Thomasville,Wyoming,29634,1420,1420,0,8/22/2021 12:08,4/14/2022 17:21
3510,1957-11-19,Thomasville,Alabama,29634,410,410,0,8/22/2021 12:27,5/23/2022 17:54
3511,1969-02-11,Thomasville,Alaska,29634,450,450,0,8/22/2021 12:29,3/2/2022 21:09
3512,1973-03-21,Thomasville,Arizona,29634,900,900,0,8/22/2021 13:53,2/19/2022 16:13
3513,1954-05-21,Thomasville,Arkansas,29634,400,400,0,8/22/2021 15:24,2/24/2022 13:18
3514,1995-09-21,Thomasville,California,29634,0,1000,1000,8/22/2021 15:44,3/5/2022 14:48
3515,1960-12-27,Thomasville,Colorado,29634,850,850,0,8/22/2021 17:22,2/18/2022 9:35
3516,1961-10-21,Thomasville,Connecticut,29634,1760,1760,0,8/22/2021 17:30,4/16/2022 17:13
3517,1995-04-06,Thomasville,Delaware,29634,500,500,0,8/22/2021 17:30,2/26/2022 19:46
3518,1981-01-01,Thomasville,District of Columbia,29634,630,1130,500,8/22/2021 18:07,5/3/2022 21:15
3519,1953-04-27,Thomasville,Florida,29634,1150,1150,0,8/22/2021 18:25,1/13/2022 19:41
3520,2005-10-25,Thomasville,Georgia,29634,8230,8230,0,8/22/2021 19:03,3/24/2022 9:01
3521,1992-08-22,Thomasville,Hawaii,29634,5635,5635,0,8/22/2021 19:09,6/30/2022 16:11
3522,2003-04-12,Thomasville,Idaho,29634,1360,5360,4000,8/22/2021 19:16,2/28/2022 17:50
3523,1951-01-14,Thomasville,Illinois,29634,3470,3470,0,8/22/2021 19:17,5/26/2022 20:11
3524,1970-06-03,Thomasville,Indiana,29634,300,800,500,8/22/2021 19:38,2/8/2022 13:52
3525,2001-06-27,Thomasville,Iowa,29634,4700,4700,0,8/22/2021 20:00,5/6/2022 11:54
3526,1987-01-25,Thomasville,Kansas,29634,6410,6410,0,8/22/2021 20:00,6/17/2022 1:03
3527,1992-07-25,Thomasville,Kentucky,29634,0,500,500,8/22/2021 20:01,2/26/2022 14:48
3528,1983-10-27,Thomasville,Louisiana,29634,400,400,0,8/22/2021 20:01,2/24/2022 18:57
3529,2003-03-07,Thomasville,Maine,29634,1310,1310,0,8/22/2021 20:01,3/29/2022 16:01
3530,1953-07-10,Thomasville,Maryland,29634,1410,1410,0,8/22/2021 20:07,4/20/2022 1:15
3531,1984-02-05,Thomasville,Massachusetts,29634,4490,4490,0,8/22/2021 20:14,6/5/2022 14:30
3532,2001-01-09,Thomasville,Michigan,29634,400,400,0,8/22/2021 20:16,1/22/2022 18:51
3533,1994-10-04,Thomasville,Minnesota,29634,270,1270,1000,8/22/2021 20:17,1/19/2022 13:15
3534,2003-04-21,Thomasville,Mississippi,29634,1650,1650,0,8/22/2021 20:18,3/25/2022 13:55
3535,1986-01-05,Thomasville,Missouri,29634,450,450,0,8/22/2021 20:18,11/13/2021 19:12
3536,2003-07-04,Thomasville,Montana,29634,3770,4270,500,8/22/2021 20:19,3/26/2022 0:25
3537,1987-01-20,Thomasville,Nebraska,29634,1160,1160,0,8/22/2021 20:19,1/22/2022 19:54
3538,2003-02-14,Thomasville,Nevada,29634,6420,6420,0,8/22/2021 20:34,4/10/2022 9:28
3539,1970-01-11,Thomasville,New Hampshire,29634,1050,1050,0,8/22/2021 20:37,9/4/2021 20:32
3540,1974-01-15,Thomasville,New Jersey,29634,700,700,0,8/22/2021 20:37,3/5/2022 15:26
3541,1955-04-17,Thomasville,New Mexico,29634,1000,1000,0,8/22/2021 20:38,2/28/2022 19:12
3542,1957-12-01,Thomasville,New York,29634,1150,1150,0,8/22/2021 20:38,3/10/2022 10:35
3543,1975-10-20,Thomasville,North Carolina,29634,1750,2250,500,8/22/2021 20:38,3/15/2022 17:20
3544,1986-04-26,Thomasville,North Dakota,29634,1010,1510,500,8/22/2021 20:40,6/9/2022 12:37
3545,1962-04-07,Thomasville,Ohio,29634,1200,1200,0,8/22/2021 20:59,1/12/2022 17:40
3546,2003-02-19,Thomasville,Oklahoma,29634,8655,8655,0,8/22/2021 21:50,6/23/2022 9:05
3547,2004-01-17,Thomasville,Oregon,29634,1910,1910,0,8/22/2021 22:13,5/5/2022 18:50
3548,2002-01-16,Thomasville,Pennsylvania,29634,1210,1210,0,8/22/2021 23:07,5/21/2022 14:53
3549,2002-10-29,Thomasville,Rhode Island,29634,1400,1400,0,8/23/2021 0:24,3/1/2022 19:40
3550,1998-09-26,Thomasville,South Carolina,29634,300,300,0,8/23/2021 0:25,1/20/2022 14:54
3551,2003-08-21,Thomasville,South Dakota,29634,2010,2010,0,8/23/2021 10:16,5/30/2022 17:44
3552,1951-12-21,Thomasville,Tennessee,29634,3000,3000,0,8/23/2021 11:44,3/2/2022 22:04
3553,1985-07-02,Thomasville,Texas,29634,6560,6560,0,8/23/2021 12:36,3/9/2022 15:23
3554,1977-08-26,Thomasville,Utah,29634,2210,2210,0,8/23/2021 13:07,4/12/2022 19:26
3555,2002-11-20,Thomasville,Vermont,29634,4490,4490,0,8/23/2021 17:08,4/16/2022 10:55
3556,1970-05-16,Thomasville,Virginia,29634,2050,2050,0,8/23/2021 18:26,3/12/2022 10:44
3557,1996-08-10,Thomasville,Washington,29634,310,310,0,8/23/2021 20:15,6/19/2022 14:21
3558,1976-01-19,Thomasville,West Virginia,29634,810,810,0,8/23/2021 20:15,5/5/2022 21:02
3559,1989-03-23,Thomasville,Wisconsin,29634,300,300,0,8/23/2021 20:15,8/23/2021 20:16
3560,1991-04-18,Thomasville,Wyoming,29634,300,300,0,8/24/2021 12:04,1/24/2022 16:27
3561,1986-02-27,Thomasville,Alabama,29634,300,300,0,8/24/2021 14:41,1/22/2022 19:19
3562,2003-08-14,Thomasville,Alaska,29634,2125,2125,0,8/24/2021 20:04,4/22/2022 13:03
3563,2001-04-16,Thomasville,Arizona,29634,1380,1380,0,8/24/2021 21:54,4/16/2022 13:16
3564,1988-08-23,Thomasville,Arkansas,29634,1400,2400,1000,8/25/2021 10:06,3/5/2022 14:30
3565,2001-03-07,Thomasville,California,29634,1280,1280,0,8/25/2021 11:06,7/1/2022 7:34
3566,1972-10-26,Thomasville,Colorado,29634,1550,1550,0,8/25/2021 12:16,3/24/2022 18:00
3567,2003-02-16,Thomasville,Connecticut,29634,2100,2100,0,8/25/2021 14:17,11/4/2021 19:09
3568,1950-02-27,Thomasville,Delaware,29634,2960,2960,0,8/25/2021 14:22,4/15/2022 18:19
3569,1978-08-12,Thomasville,District of Columbia,29634,3750,3750,0,8/25/2021 14:59,3/2/2022 20:11
3570,1996-01-03,Thomasville,Florida,29634,2000,2000,0,8/25/2021 17:52,3/27/2022 13:44
3571,1996-12-17,Thomasville,Georgia,29634,8500,8500,0,8/25/2021 18:23,5/6/2022 11:36
3572,2003-05-10,Greensboro,North Carolina,27410,9520,9520,0,8/25/2021 20:34,5/6/2022 11:31
3573,1998-06-29,Winston-Salem,North Carolina,27101,1890,7890,6000,8/25/2021 20:42,7/1/2022 8:14
3572,2003-05-10,Greensboro,North Carolina,27410,9520,9520,0,8/25/2021 20:34,5/6/2022 11:31
3573,1998-06-29,Winston-Salem,North Carolina,27101,1890,7890,6000,8/25/2021 20:42,7/1/2022 8:14
3574,2001-09-15,Thomasville,Hawaii,29634,910,910,0,8/25/2021 20:46,4/8/2022 12:45
3575,2004-02-22,Thomasville,Idaho,29634,2510,2510,0,8/25/2021 21:15,5/3/2022 13:00
3576,1992-06-01,Thomasville,Illinois,29634,450,450,0,8/25/2021 21:52,9/26/2021 17:15
3577,2002-02-21,Thomasville,Indiana,29634,3630,3630,0,8/25/2021 22:03,4/14/2022 18:16
3578,1988-07-10,Thomasville,Iowa,29634,3740,3740,0,8/25/2021 22:04,4/20/2022 20:59
3579,2001-09-18,Winston-Salem,North Carolina,27109,3040,3040,0,8/26/2021 0:07,5/14/2022 12:20
3580,2003-06-11,Palmetto Bay,Florida,33157,1400,1400,0,8/26/2021 8:59,11/30/2021 14:26
3581,2002-12-24,Thomasville,Kansas,29634,2640,2640,0,8/26/2021 9:23,1/18/2022 19:00
3582,1999-02-15,Winston-Salem,North Carolina,27106,8475,8475,0,8/26/2021 10:28,4/9/2022 23:21
3583,1998-11-13,Thomasville,Kentucky,29634,7585,7585,0,8/26/2021 10:30,5/31/2022 18:59
3584,1954-12-16,Thomasville,Louisiana,29634,710,710,0,8/26/2021 10:45,5/4/2022 12:02
3585,1998-05-28,Winston-Salem,North Carolina,27106,3310,20310,17000,8/26/2021 13:10,6/13/2022 17:47
3586,1999-06-28,Thomasville,Maine,29634,2610,2610,0,8/26/2021 13:13,3/14/2022 9:02
3587,1982-05-20,Thomasville,Maryland,29634,400,400,0,8/26/2021 13:24,3/14/2022 9:39
3588,2002-09-24,Thomasville,Massachusetts,29634,110,610,500,8/26/2021 13:44,5/4/2022 9:15
3589,2002-12-19,Thomasville,Michigan,29634,360,860,500,8/26/2021 13:45,5/28/2022 12:12
3590,1966-12-15,Thomasville,Minnesota,29634,2290,2290,0,8/26/2021 13:47,5/26/2022 20:06
3591,1999-12-15,Thomasville,Mississippi,29634,1010,1010,0,8/26/2021 14:02,4/10/2022 11:21
3592,1998-04-22,Thomasville,Missouri,29634,2090,2090,0,8/26/2021 14:19,6/10/2022 23:45
3593,1997-10-15,Thomasville,Montana,29634,1450,1450,0,8/26/2021 14:23,3/21/2022 9:09
3594,1983-05-06,Thomasville,Nebraska,29634,710,710,0,8/26/2021 14:27,4/15/2022 12:32
3595,1976-05-10,Thomasville,Nevada,29634,1370,1370,0,8/26/2021 14:27,4/18/2022 22:22
3596,1973-11-27,Thomasville,New Hampshire,29634,1610,1610,0,8/26/2021 14:49,1/12/2022 18:41
3597,1973-12-21,Thomasville,New Jersey,29634,860,860,0,8/26/2021 14:52,1/18/2022 14:57
3598,1998-10-22,Ormond Beach,Florida,32174,3680,3680,0,8/26/2021 14:53,5/2/2022 22:12
3599,1970-05-19,Thomasville,New Mexico,29634,1000,1500,500,8/26/2021 15:05,3/11/2022 19:38
3600,2002-10-27,Thomasville,New York,29634,2210,3710,1500,8/26/2021 15:24,3/29/2022 11:49
3601,2003-08-06,Thomasville,North Carolina,29634,8530,8530,0,8/26/2021 15:48,5/27/2022 12:39
3602,1964-07-27,Thomasville,North Dakota,29634,1500,1500,0,8/26/2021 15:52,3/2/2022 21:11
3603,1968-07-24,Thomasville,Ohio,29634,360,360,0,8/26/2021 15:53,4/8/2022 11:23
3604,1960-06-27,Thomasville,Oklahoma,29634,1090,1590,500,8/26/2021 16:35,4/11/2022 17:51
3605,1961-08-17,Thomasville,Oregon,29634,2640,2640,0,8/26/2021 17:05,5/2/2022 18:02
3606,1986-02-11,Thomasville,Pennsylvania,29634,300,300,0,8/26/2021 17:24,3/21/2022 20:07
3607,1998-12-21,Thomasville,Rhode Island,29634,560,560,0,8/26/2021 17:26,3/14/2022 11:57
3608,1997-07-03,Thomasville,South Carolina,29634,2160,2160,0,8/26/2021 17:32,2/19/2022 11:58
3609,1998-10-21,Thomasville,South Dakota,29634,2785,2785,0,8/26/2021 17:40,4/22/2022 14:12
3610,1971-06-25,Thomasville,Tennessee,29634,750,750,0,8/26/2021 17:42,11/3/2021 20:11
3611,1962-09-19,Thomasville,Texas,29634,1790,6290,4500,8/26/2021 17:56,5/3/2022 18:03
3612,2002-10-06,Thomasville,Utah,29634,3200,3200,0,8/26/2021 18:03,6/27/2022 21:12
3613,1991-12-20,Thomasville,Vermont,29634,300,300,0,8/26/2021 18:06,3/16/2022 18:28
3614,1999-07-20,Thomasville,Virginia,29634,3980,3980,0,8/26/2021 18:07,5/3/2022 19:24
3615,2000-07-28,Thomasville,Washington,29634,16425,16425,0,8/26/2021 18:18,3/2/2022 22:40
3616,1959-12-26,Thomasville,West Virginia,29634,450,450,0,8/26/2021 18:18,10/2/2021 12:27
3617,2004-11-23,Thomasville,Wisconsin,29634,500,500,0,8/26/2021 18:18,11/18/2021 18:23
3618,2003-08-12,Thomasville,Wyoming,29634,2760,2760,0,8/26/2021 18:25,5/3/2022 13:05
3619,2005-05-28,Thomasville,Alabama,29634,1310,1310,0,8/26/2021 18:26,2/28/2022 16:59
3620,1971-11-11,Thomasville,Alaska,29634,700,700,0,8/26/2021 18:27,3/24/2022 2:50
3621,1984-07-15,Thomasville,Arizona,29634,300,300,0,8/26/2021 18:28,1/12/2022 18:01
3622,1957-06-21,Thomasville,Arkansas,29634,450,450,0,8/26/2021 18:31,2/24/2022 15:02
3623,2001-07-10,Thomasville,California,29634,1360,2360,1000,8/26/2021 18:31,4/15/2022 15:08
3624,1979-09-19,Thomasville,Colorado,29634,1455,1455,0,8/26/2021 18:31,4/15/2022 18:55
3625,1991-05-16,Thomasville,Connecticut,29634,2280,2280,0,8/26/2021 18:39,6/30/2022 19:51
3626,1993-01-04,Thomasville,Delaware,29634,4330,4330,0,8/26/2021 18:42,4/9/2022 14:29
3627,1983-03-17,Thomasville,District of Columbia,29634,400,400,0,8/26/2021 18:44,12/11/2021 18:09
3628,1994-03-27,Thomasville,Florida,29634,300,300,0,8/26/2021 18:45,3/30/2022 11:03
3629,1966-12-15,Thomasville,Georgia,29634,1220,1220,0,8/26/2021 18:47,5/10/2022 18:05
3630,1995-01-21,Thomasville,Hawaii,29634,1100,1100,0,8/26/2021 18:48,3/19/2022 15:33
3631,1973-12-11,Thomasville,Idaho,29634,900,1900,1000,8/26/2021 18:49,3/25/2022 17:20
3632,1993-12-17,Thomasville,Illinois,29634,1070,1070,0,8/26/2021 18:49,6/16/2022 17:36
3633,1960-01-12,Thomasville,Indiana,29634,460,960,500,8/26/2021 18:52,2/9/2022 11:49
3634,1990-07-05,Thomasville,Iowa,29634,1410,1410,0,8/26/2021 18:52,2/19/2022 13:16
3635,1999-08-19,Thomasville,Kansas,29634,400,400,0,8/26/2021 18:53,4/1/2022 14:21
3636,1986-01-01,Thomasville,Kentucky,29634,2825,2825,0,8/26/2021 18:53,4/21/2022 20:21
3637,1959-08-03,Thomasville,Louisiana,29634,460,460,0,8/26/2021 18:53,4/9/2022 10:16
3638,2002-09-19,Thomasville,Maine,29634,2660,2660,0,8/26/2021 18:54,4/19/2022 9:27
3639,1998-10-20,Thomasville,Maryland,29634,1250,1250,0,8/26/2021 18:55,3/2/2022 21:47
3640,1961-09-11,Thomasville,Massachusetts,29634,950,950,0,8/26/2021 18:55,1/18/2022 18:34
3641,1998-09-01,Thomasville,Michigan,29634,880,2880,2000,8/26/2021 18:55,3/8/2022 22:58
3642,2002-07-10,Thomasville,Minnesota,29634,1010,2010,1000,8/26/2021 18:56,3/13/2022 22:15
3643,1965-01-04,Thomasville,Mississippi,29634,1180,1680,500,8/26/2021 18:59,4/5/2022 13:42
3644,1989-11-16,Thomasville,Missouri,29634,570,570,0,8/26/2021 18:59,4/17/2022 20:36
3645,1986-05-06,Thomasville,Montana,29634,410,410,0,8/26/2021 18:59,5/11/2022 11:06
3646,1962-02-16,Thomasville,Nebraska,29634,1310,1310,0,8/26/2021 19:01,4/18/2022 19:32
3647,1996-05-08,Thomasville,Nevada,29634,1450,1450,0,8/26/2021 19:01,6/6/2022 21:52
3648,1965-05-07,Thomasville,New Hampshire,29634,1750,1750,0,8/26/2021 19:01,2/22/2022 11:12
3649,1992-07-25,Thomasville,New Jersey,29634,1100,1100,0,8/26/2021 19:02,3/2/2022 20:04
3650,1963-03-17,Thomasville,New Mexico,29634,2160,2160,0,8/26/2021 19:05,4/30/2022 19:52
3651,2001-03-07,Thomasville,New York,29634,6460,12460,6000,8/26/2021 19:06,4/17/2022 13:01
3652,1973-02-24,Thomasville,North Carolina,29634,960,960,0,8/26/2021 19:07,6/26/2022 16:32
3653,1976-06-24,Thomasville,North Dakota,29634,2680,2680,0,8/26/2021 19:07,4/18/2022 11:04
3654,1962-06-10,Thomasville,Ohio,29634,5620,5620,0,8/26/2021 19:07,4/10/2022 14:12
3655,1969-08-25,Thomasville,Oklahoma,29634,2370,2370,0,8/26/2021 19:07,5/9/2022 18:03
3656,1972-12-11,Thomasville,Oregon,29634,800,800,0,8/26/2021 19:07,1/27/2022 17:46
3657,2002-09-18,Thomasville,Pennsylvania,29634,1070,1070,0,8/26/2021 19:07,5/2/2022 18:00
3658,1975-02-07,Thomasville,Rhode Island,29634,1700,1700,0,8/26/2021 19:07,3/16/2022 10:18
3659,1978-03-26,Thomasville,South Carolina,29634,400,400,0,8/26/2021 19:08,9/14/2021 11:33
3660,1983-09-28,Thomasville,South Dakota,29634,2280,2280,0,8/26/2021 19:08,5/26/2022 20:15
3661,1999-01-28,Thomasville,Tennessee,29634,600,600,0,8/26/2021 19:08,4/6/2022 9:00
3662,1950-07-08,Thomasville,Texas,29634,2670,2670,0,8/26/2021 19:08,3/14/2022 9:59
3663,1999-08-24,Thomasville,Utah,29634,810,1310,500,8/26/2021 19:09,5/27/2022 0:14
3664,2003-05-20,Thomasville,Vermont,29634,2530,2530,0,8/26/2021 19:09,4/10/2022 16:37
3665,1967-07-19,Thomasville,Virginia,29634,850,850,0,8/26/2021 19:09,3/26/2022 17:15
3666,1994-05-14,Thomasville,Washington,29634,2080,2080,0,8/26/2021 19:10,4/18/2022 10:58
3667,1987-10-28,Thomasville,West Virginia,29634,700,700,0,8/26/2021 19:10,1/28/2022 20:27
3668,1968-09-03,Thomasville,Wisconsin,29634,2320,2320,0,8/26/2021 19:11,4/8/2022 19:03
3669,1992-09-25,Thomasville,Wyoming,29634,3330,3330,0,8/26/2021 19:12,5/11/2022 8:33
3670,1968-12-05,Thomasville,Alabama,29634,550,550,0,8/26/2021 19:12,2/17/2022 13:38
3671,2003-04-22,Thomasville,Alaska,29634,5285,5285,0,8/26/2021 19:13,3/16/2022 18:37
3672,1991-08-06,Thomasville,Arizona,29634,1400,1400,0,8/26/2021 19:13,3/9/2022 18:34
3673,1962-04-06,Thomasville,Arkansas,29634,1260,1260,0,8/26/2021 19:14,4/15/2022 18:48
3674,2002-12-14,Thomasville,California,29634,6550,6550,0,8/26/2021 19:15,3/17/2022 12:49
3675,1974-02-05,Thomasville,Colorado,29634,800,800,0,8/26/2021 19:15,3/1/2022 23:23
3676,2003-05-21,Thomasville,Connecticut,29634,610,610,0,8/26/2021 19:15,4/28/2022 3:00
3677,1993-09-25,Thomasville,Delaware,29634,1050,1050,0,8/26/2021 19:15,3/2/2022 19:22
3678,1999-05-23,Winston-Salem ,North Carolina,27106,7500,13500,6000,8/26/2021 19:15,5/5/2022 1:55
3679,2002-01-04,Thomasville,District of Columbia,29634,100,600,500,8/26/2021 19:15,3/2/2022 12:17
3680,1972-02-23,Thomasville,Florida,29634,550,550,0,8/26/2021 19:16,2/18/2022 18:20
3681,1963-09-16,Thomasville,Georgia,29634,1110,1110,0,8/26/2021 19:17,4/12/2022 15:25
3682,1960-06-11,Thomasville,Hawaii,29634,1235,1235,0,8/26/2021 19:17,3/1/2022 19:35
3683,1993-03-14,Thomasville,Idaho,29634,2630,2630,0,8/26/2021 19:17,4/22/2022 13:28
3684,2004-12-15,Thomasville,Illinois,29634,1450,1450,0,8/26/2021 19:18,3/19/2022 16:11
3685,1970-04-27,Thomasville,Indiana,29634,3800,3800,0,8/26/2021 19:19,3/2/2022 22:15
3686,1952-07-06,Thomasville,Iowa,29634,2500,2500,0,8/26/2021 19:19,6/26/2022 8:25
3687,1967-11-06,Thomasville,Kansas,29634,800,1300,500,8/26/2021 19:20,1/22/2022 19:58
3688,1996-08-14,Thomasville,Kentucky,29634,310,310,0,8/26/2021 19:20,6/7/2022 17:27
3689,1951-03-26,Thomasville,Louisiana,29634,660,660,0,8/26/2021 19:21,1/18/2022 14:44
3690,1992-09-10,Thomasville,Maine,29634,50,550,500,8/26/2021 19:21,1/12/2022 19:03
3691,1996-04-02,Thomasville,Maryland,29634,1890,1890,0,8/26/2021 19:21,5/8/2022 14:46
3692,1957-02-28,Thomasville,Massachusetts,29634,250,750,500,8/26/2021 19:22,3/27/2022 14:22
3693,2002-11-10,Thomasville,Michigan,29634,1600,1600,0,8/26/2021 19:22,1/22/2022 19:32
3694,1982-05-06,Thomasville,Minnesota,29634,3080,3080,0,8/26/2021 19:22,4/16/2022 16:37
3695,1961-08-27,Thomasville,Mississippi,29634,300,300,0,8/26/2021 19:24,8/26/2021 19:24
3696,1981-06-09,Thomasville,Missouri,29634,850,1350,500,8/26/2021 19:26,2/8/2022 21:10
3697,1958-06-18,Thomasville,Montana,29634,1460,1460,0,8/26/2021 19:26,4/14/2022 18:00
3698,1997-05-04,Thomasville,Nebraska,29634,600,600,0,8/26/2021 19:26,3/2/2022 11:50
3699,1950-04-15,Thomasville,Nevada,29634,1050,1050,0,8/26/2021 19:26,3/19/2022 16:44
3700,1987-12-12,Thomasville,New Hampshire,29634,2950,2950,0,8/26/2021 19:27,7/1/2022 8:01
3701,1983-01-06,Thomasville,New Jersey,29634,2130,3130,1000,8/26/2021 19:27,4/22/2022 20:12
3702,1972-05-25,Thomasville,New Mexico,29634,700,700,0,8/26/2021 19:28,1/12/2022 17:25
3703,2000-10-22,Thomasville,New York,29634,520,520,0,8/26/2021 19:28,4/29/2022 16:06
3704,1969-02-25,Thomasville,North Carolina,29634,2260,2260,0,8/26/2021 19:29,3/18/2022 0:47
3705,1970-06-09,Thomasville,North Dakota,29634,900,1400,500,8/26/2021 19:29,2/26/2022 17:13
3706,1975-01-17,Thomasville,Ohio,29634,660,660,0,8/26/2021 19:29,6/18/2022 11:41
3707,2000-11-03,Thomasville,Oklahoma,29634,760,760,0,8/26/2021 19:29,5/3/2022 18:10
3708,1995-01-12,Vienna,Virginia,22180,920,920,0,8/26/2021 19:29,1/22/2022 19:51
3709,1989-12-08,Thomasville,Oregon,29634,550,550,0,8/26/2021 19:30,1/12/2022 10:59
3710,1996-09-16,Thomasville,Pennsylvania,29634,1100,1100,0,8/26/2021 19:31,1/22/2022 18:51
3711,1954-11-14,Thomasville,Rhode Island,29634,970,970,0,8/26/2021 19:31,6/30/2022 20:12
3712,1980-12-20,Thomasville,South Carolina,29634,700,700,0,8/26/2021 19:31,1/12/2022 19:04
3713,1974-11-04,Thomasville,South Dakota,29634,410,410,0,8/26/2021 19:31,4/12/2022 15:04
3714,1988-06-15,Thomasville,Tennessee,29634,2960,2960,0,8/26/2021 19:32,4/27/2022 15:11
3715,1999-05-30,Thomasville,Texas,29634,21780,21780,0,8/26/2021 19:32,6/30/2022 20:14
3716,2003-01-27,Thomasville,Utah,29634,100,1100,1000,8/26/2021 19:33,3/1/2022 23:25
3717,1978-04-12,Thomasville,Vermont,29634,400,400,0,8/26/2021 19:35,2/12/2022 0:02
3718,1990-12-08,Thomasville,Virginia,29634,810,810,0,8/26/2021 19:35,3/2/2022 20:31
3719,2001-12-27,Thomasville,Washington,29634,300,300,0,8/26/2021 19:35,4/2/2022 20:49
3720,1990-04-23,Thomasville,West Virginia,29634,500,500,0,8/26/2021 19:36,11/18/2021 20:04
3721,1960-10-06,Thomasville,Wisconsin,29634,5210,5210,0,8/26/2021 19:36,6/1/2022 8:01
3722,1999-07-20,Thomasville,Wyoming,29634,5410,5410,0,8/26/2021 19:36,3/26/2022 18:06
3723,1957-06-03,Thomasville,Alabama,29634,950,950,0,8/26/2021 19:37,11/3/2021 21:26
3724,1962-12-17,Thomasville,Alaska,29634,410,910,500,8/26/2021 19:37,1/22/2022 16:35
3725,1963-03-01,Thomasville,Arizona,29634,450,450,0,8/26/2021 19:37,1/10/2022 9:09
3726,2003-10-31,Thomasville,Arkansas,29634,1880,2880,1000,8/26/2021 19:38,6/14/2022 15:50
3727,1999-09-19,Thomasville,California,29634,2020,2020,0,8/26/2021 19:38,5/18/2022 16:43
3728,1994-12-02,Thomasville,Colorado,29634,1470,1470,0,8/26/2021 19:39,4/12/2022 12:55
3729,1976-12-12,Thomasville,Connecticut,29634,360,1360,1000,8/26/2021 19:40,4/3/2022 17:00
3730,1990-08-18,Thomasville,Delaware,29634,450,450,0,8/26/2021 19:40,1/12/2022 16:10
3731,1978-03-01,Thomasville,District of Columbia,29634,1520,1520,0,8/26/2021 19:43,2/26/2022 20:59
3732,1996-07-14,Thomasville,Florida,29634,450,450,0,8/26/2021 19:43,1/10/2022 21:31
3733,1983-04-01,Thomasville,Georgia,29634,610,610,0,8/26/2021 19:44,5/9/2022 18:30
3734,1966-10-24,Thomasville,Hawaii,29634,710,710,0,8/26/2021 19:44,5/27/2022 13:17
3735,2003-02-21,Thomasville,Idaho,29634,450,950,500,8/26/2021 19:45,2/22/2022 14:59
3736,1993-09-08,Thomasville,Illinois,29634,2010,2010,0,8/26/2021 19:45,4/19/2022 3:29
3737,1963-09-23,Thomasville,Indiana,29634,300,300,0,8/26/2021 19:45,2/27/2022 1:35
3738,2003-02-14,Thomasville,Iowa,29634,2710,2710,0,8/26/2021 19:46,7/1/2022 8:02
3739,1990-07-23,Thomasville,Kansas,29634,1310,1310,0,8/26/2021 19:46,4/26/2022 13:35
3740,1987-01-11,Thomasville,Kentucky,29634,1000,1000,0,8/26/2021 19:47,3/27/2022 12:04
3741,1985-03-24,Thomasville,Louisiana,29634,2230,2230,0,8/26/2021 19:49,4/16/2022 13:06
3742,1977-12-16,Thomasville,Maine,29634,8980,8980,0,8/26/2021 19:49,4/18/2022 18:01
3743,1994-06-06,Thomasville,Maryland,29634,4525,4525,0,8/26/2021 19:50,4/10/2022 14:07
3744,1959-12-11,Thomasville,Massachusetts,29634,5080,5080,0,8/26/2021 19:50,4/8/2022 19:14
3745,1960-06-08,Thomasville,Michigan,29634,300,300,0,8/26/2021 19:51,3/2/2022 17:30
3746,1969-01-26,Thomasville,Minnesota,29634,530,530,0,8/26/2021 19:51,4/19/2022 19:20
3747,1994-11-16,Thomasville,Mississippi,29634,2240,2240,0,8/26/2021 19:52,5/7/2022 16:26
3748,1993-10-28,Thomasville,Missouri,29634,400,400,0,8/26/2021 19:54,8/26/2021 19:56
3749,2002-06-11,Thomasville,Montana,29634,1085,1085,0,8/26/2021 19:55,11/19/2021 18:00
3750,1987-04-11,Thomasville,Nebraska,29634,3750,3750,0,8/26/2021 19:55,3/14/2022 15:46
3751,2002-07-16,Thomasville,Nevada,29634,4560,4560,0,8/26/2021 19:55,7/1/2022 1:06
3752,1978-04-18,Thomasville,New Hampshire,29634,1500,1500,0,8/26/2021 19:55,1/12/2022 18:06
3753,1950-06-01,Thomasville,New Jersey,29634,1830,1830,0,8/26/2021 19:55,3/14/2022 9:00
3754,1994-04-13,Thomasville,New Mexico,29634,1600,1600,0,8/26/2021 19:55,2/19/2022 13:01
3755,2001-11-18,Thomasville,New York,29634,3450,3450,0,8/26/2021 19:56,6/30/2022 11:56
3756,1968-10-05,Thomasville,North Carolina,29634,1100,1100,0,8/26/2021 19:57,12/8/2021 21:07
3757,2005-04-07,Thomasville,North Dakota,29634,1020,1020,0,8/26/2021 19:57,4/12/2022 18:46
3758,2000-01-12,Thomasville,Ohio,29634,650,650,0,8/26/2021 19:58,1/22/2022 17:03
3759,2000-05-21,Thomasville,Oklahoma,29634,300,300,0,8/26/2021 19:59,3/26/2022 21:37
3760,1993-10-16,Thomasville,Oregon,29634,300,300,0,8/26/2021 19:59,3/2/2022 20:41
3761,1984-09-28,Thomasville,Pennsylvania,29634,800,800,0,8/26/2021 19:59,1/12/2022 19:03
3762,2003-03-28,Thomasville,Rhode Island,29634,400,400,0,8/26/2021 20:01,3/2/2022 21:27
3763,1973-07-14,Thomasville,South Carolina,29634,1760,1760,0,8/26/2021 20:01,3/22/2022 9:56
3764,1954-12-25,Thomasville,South Dakota,29634,1050,1050,0,8/26/2021 20:03,1/12/2022 14:49
3765,1983-07-22,Thomasville,Tennessee,29634,1670,1670,0,8/26/2021 20:07,5/6/2022 12:03
3766,1995-07-30,Thomasville,Texas,29634,0,2500,2500,8/26/2021 20:33,2/23/2022 18:49
3767,1952-08-11,Thomasville,Utah,29634,800,800,0,8/26/2021 20:49,3/2/2022 15:08
3768,1972-02-01,Thomasville,Vermont,29634,750,750,0,8/26/2021 21:10,1/12/2022 12:03
3769,1983-09-04,Thomasville,Virginia,29634,800,800,0,8/26/2021 21:24,3/15/2022 11:05
3770,1972-11-18,Thomasville,Washington,29634,1200,1200,0,8/26/2021 21:35,1/22/2022 19:48
3771,2003-05-31,Thomasville,West Virginia,29634,2700,2700,0,8/26/2021 22:41,5/29/2022 0:44
3772,2002-11-10,Thomasville,Wisconsin,29634,820,1320,500,8/26/2021 23:08,4/15/2022 21:50
3773,1951-10-26,Thomasville,Wyoming,29634,2195,2195,0,8/27/2021 10:18,2/19/2022 12:42
3774,1969-05-28,Thomasville,Alabama,29634,600,600,0,8/27/2021 10:38,2/19/2022 17:49
3775,1968-10-09,Thomasville,Alaska,29634,1150,1150,0,8/27/2021 11:49,3/16/2022 15:07
3776,1999-02-07,Thomasville,Arizona,29634,800,800,0,8/27/2021 13:19,11/30/2021 21:22
3777,1992-01-12,Thomasville,Arkansas,29634,675,675,0,8/27/2021 14:41,3/16/2022 16:49
3778,1966-09-27,Thomasville,California,29634,600,600,0,8/27/2021 14:44,1/22/2022 21:32
3779,2000-05-23,Thomasville,Colorado,29634,400,400,0,8/27/2021 15:21,2/11/2022 16:01
3780,1966-12-02,Thomasville,Connecticut,29634,880,880,0,8/27/2021 17:52,5/3/2022 9:02
3781,1967-01-10,Thomasville,Delaware,29634,300,300,0,8/27/2021 18:24,9/3/2021 17:18
3782,2001-07-07,Thomasville,District of Columbia,29634,1420,1420,0,8/27/2021 19:03,4/19/2022 19:15
3783,1999-01-06,Thomasville,Florida,29634,6630,6630,0,8/27/2021 19:06,6/30/2022 7:10
3784,1965-08-11,Thomasville,Georgia,29634,300,300,0,8/27/2021 20:57,3/2/2022 18:36
3785,1987-07-16,Thomasville,Hawaii,29634,1060,1060,0,8/27/2021 21:12,5/25/2022 14:17
3786,2001-10-22,Thomasville,Idaho,29634,600,600,0,8/27/2021 23:04,3/9/2022 15:33
3787,2000-04-03,Thomasville,Illinois,29634,1370,1370,0,8/28/2021 1:00,3/1/2022 12:02
3788,1952-10-19,Thomasville,Indiana,29634,1000,1000,0,8/28/2021 13:02,11/27/2021 20:00
3789,1989-06-18,Thomasville,Iowa,29634,2060,2060,0,8/28/2021 13:42,6/30/2022 7:45
3790,1978-09-02,Thomasville,Kansas,29634,500,500,0,8/28/2021 18:29,1/24/2022 17:58
3791,1987-03-02,Thomasville,Kentucky,29634,300,300,0,8/28/2021 18:35,11/13/2021 18:44
3792,2001-09-11,Fort Myers ,Florida,33908,910,910,0,8/28/2021 19:18,4/7/2022 21:57
3793,1996-10-28,Winston-Salem,North Carolina,27101,500,500,0,8/28/2021 21:30,11/8/2021 19:37
3794,2003-02-14,Thomasville,Louisiana,29634,9085,9085,0,8/28/2021 22:21,5/16/2022 1:14
3795,1965-10-27,Thomasville,Maine,29634,450,450,0,8/29/2021 0:26,11/16/2021 1:57
3796,1993-09-13,Winston-Salem,North Carolina,27106,70,1570,1500,8/29/2021 12:46,4/15/2022 13:18
3797,1953-07-07,Thomasville,Maryland,29634,1720,2220,500,8/29/2021 12:58,5/10/2022 18:01
3798,1969-11-12,Thomasville,Massachusetts,29634,700,700,0,8/29/2021 13:04,2/26/2022 13:52
3799,1952-05-09,Thomasville,Michigan,29634,2880,2880,0,8/29/2021 13:05,6/11/2022 17:52
3800,1954-04-06,Thomasville,Minnesota,29634,2260,3760,1500,8/29/2021 13:19,4/11/2022 14:15
3801,1987-10-03,Thomasville,Mississippi,29634,5880,5880,0,8/29/2021 13:22,5/1/2022 18:52
3802,1980-03-24,Thomasville,Missouri,29634,2030,2030,0,8/29/2021 13:26,5/11/2022 13:02
3803,1967-10-03,Thomasville,Montana,29634,650,650,0,8/29/2021 13:28,9/17/2021 17:31
3804,1985-05-02,Thomasville,Nebraska,29634,450,450,0,8/29/2021 13:28,12/8/2021 18:14
3805,1950-02-05,Thomasville,Nevada,29634,2370,2370,0,8/29/2021 13:45,5/3/2022 13:00
3806,2002-05-14,Thomasville,New Hampshire,29634,2960,2960,0,8/29/2021 13:45,5/8/2022 15:48
3807,1961-06-22,Thomasville,New Jersey,29634,520,520,0,8/29/2021 13:48,5/27/2022 12:24
3808,2021-06-15,Thomasville,New Mexico,29634,2310,2310,0,8/29/2021 13:49,4/24/2022 10:13
3809,1979-11-10,Thomasville,New York,29634,4920,5920,1000,8/29/2021 13:49,5/16/2022 8:48
3810,2001-06-08,Thomasville,North Carolina,29634,450,450,0,8/29/2021 14:14,3/2/2022 21:17
3811,1968-10-15,Thomasville,North Dakota,29634,1880,1880,0,8/29/2021 15:42,5/11/2022 17:25
3812,1979-10-25,Thomasville,Ohio,29634,200,650,450,8/29/2021 15:54,2/26/2022 18:46
3813,1983-01-19,Thomasville,Oklahoma,29634,1050,1050,0,8/29/2021 15:56,4/3/2022 10:29
3814,1965-07-10,Thomasville,Oregon,29634,900,900,0,8/29/2021 16:23,3/2/2022 20:34
3815,1981-07-16,Thomasville,Pennsylvania,29634,510,510,0,8/29/2021 16:34,4/19/2022 19:46
3816,1980-04-05,Thomasville,Rhode Island,29634,560,560,0,8/29/2021 16:51,4/9/2022 15:11
3817,1950-03-08,Thomasville,South Carolina,29634,310,310,0,8/29/2021 16:55,4/7/2022 18:01
3818,1955-02-15,Thomasville,South Dakota,29634,1430,1430,0,8/29/2021 17:00,6/15/2022 8:17
3819,2005-02-10,Thomasville,Tennessee,29634,400,400,0,8/29/2021 17:19,1/22/2022 18:05
3820,1964-06-11,Thomasville,Texas,29634,300,300,0,8/29/2021 17:57,11/13/2021 18:28
3821,2001-06-13,Thomasville,Utah,29634,3410,3410,0,8/29/2021 18:18,4/14/2022 10:58
3822,1972-08-26,Thomasville,Vermont,29634,900,900,0,8/29/2021 18:24,1/12/2022 19:51
3823,1976-04-03,Thomasville,Virginia,29634,1200,1200,0,8/29/2021 18:34,2/26/2022 20:54
3824,1992-07-04,Thomasville,Washington,29634,410,410,0,8/29/2021 18:36,5/31/2022 23:34
3825,2003-06-07,Thomasville,West Virginia,29634,4310,4310,0,8/29/2021 18:42,6/30/2022 23:37
3826,1997-05-13,Thomasville,Wisconsin,29634,4760,4760,0,8/29/2021 18:43,4/9/2022 14:23
3827,1991-07-23,Thomasville,Wyoming,29634,450,450,0,8/29/2021 18:47,11/27/2021 19:01
3828,2001-10-23,Thomasville,Alabama,29634,500,500,0,8/29/2021 18:50,11/19/2021 11:56
3829,1972-12-03,Thomasville,Alaska,29634,2115,2115,0,8/29/2021 18:52,5/8/2022 12:05
3830,1955-05-04,Thomasville,Arizona,29634,2500,2500,0,8/29/2021 18:53,3/2/2022 10:01
3831,1965-01-24,Thomasville,Arkansas,29634,1350,1350,0,8/29/2021 18:56,3/15/2022 19:26
3832,1969-06-24,Thomasville,California,29634,500,500,0,8/29/2021 18:56,2/25/2022 21:24
3833,1973-03-22,Thomasville,Colorado,29634,1100,1100,0,8/29/2021 18:56,11/13/2021 21:00
3834,1961-01-25,Thomasville,Connecticut,29634,450,450,0,8/29/2021 18:56,1/12/2022 17:38
3835,1967-08-23,Thomasville,Delaware,29634,750,750,0,8/29/2021 18:57,3/25/2022 10:04
3836,1978-06-05,Thomasville,District of Columbia,29634,1220,1220,0,8/29/2021 18:58,4/16/2022 16:39
3837,1954-10-04,Thomasville,Florida,29634,1450,1450,0,8/29/2021 18:58,2/25/2022 18:44
3838,1959-10-04,Thomasville,Georgia,29634,450,450,0,8/29/2021 18:58,3/22/2022 10:04
3839,2004-10-02,Thomasville,Hawaii,29634,350,350,0,8/29/2021 18:58,3/15/2022 17:19
3840,2003-11-20,Thomasville,Idaho,29634,300,300,0,8/29/2021 18:59,12/2/2021 13:43
3841,1952-04-06,Thomasville,Illinois,29634,810,810,0,8/29/2021 18:59,4/9/2022 12:51
3842,1965-07-15,Thomasville,Indiana,29634,2050,2050,0,8/29/2021 18:59,3/25/2022 18:30
3843,1982-12-24,Thomasville,Iowa,29634,400,400,0,8/29/2021 19:00,11/13/2021 17:14
3844,1962-08-25,Thomasville,Kansas,29634,660,660,0,8/29/2021 19:01,4/9/2022 14:15
3845,1963-02-07,Thomasville,Kentucky,29634,3390,3390,0,8/29/2021 19:02,4/16/2022 14:04
3846,1975-06-05,Thomasville,Louisiana,29634,350,1350,1000,8/29/2021 19:02,11/30/2021 18:13
3847,1965-08-12,Thomasville,Maine,29634,400,400,0,8/29/2021 19:03,2/9/2022 11:31
3848,2005-03-09,Thomasville,Maryland,29634,300,300,0,8/29/2021 19:03,11/18/2021 18:39
3849,1963-03-11,Thomasville,Massachusetts,29634,850,850,0,8/29/2021 19:04,3/16/2022 11:24
3850,1992-12-09,Thomasville,Michigan,29634,320,320,0,8/29/2021 19:04,4/8/2022 17:59
3851,1996-05-23,Thomasville,Minnesota,29634,1510,1510,0,8/29/2021 19:04,4/16/2022 17:33
3852,1990-09-28,Thomasville,Mississippi,29634,300,300,0,8/29/2021 19:06,2/12/2022 15:08
3853,1970-04-02,Thomasville,Missouri,29634,1110,1110,0,8/29/2021 19:07,4/19/2022 18:31
3854,1996-03-19,Thomasville,Montana,29634,1550,2050,500,8/29/2021 19:08,3/25/2022 14:14
3855,1987-12-02,Thomasville,Nebraska,29634,1860,1860,0,8/29/2021 19:09,5/20/2022 4:46
3856,1995-04-16,Thomasville,Nevada,29634,750,750,0,8/29/2021 19:09,3/2/2022 20:36
3857,1987-01-07,Thomasville,New Hampshire,29634,1735,1735,0,8/29/2021 19:09,1/12/2022 17:33
3858,1967-05-16,Thomasville,New Jersey,29634,1740,1740,0,8/29/2021 19:09,5/11/2022 12:13
3859,1988-03-17,Thomasville,New Mexico,29634,2020,2020,0,8/29/2021 19:09,4/15/2022 18:17
3860,1979-06-10,Thomasville,New York,29634,1670,1670,0,8/29/2021 19:10,4/15/2022 19:01
3861,2003-02-10,Thomasville,North Carolina,29634,4840,4840,0,8/29/2021 19:10,7/1/2022 8:11
3862,1984-05-05,Thomasville,North Dakota,29634,760,760,0,8/29/2021 19:10,4/15/2022 18:21
3863,1993-02-16,Thomasville,Ohio,29634,1570,1570,0,8/29/2021 19:10,6/10/2022 15:41
3864,1999-03-08,Thomasville,Oklahoma,29634,1560,1560,0,8/29/2021 19:13,4/20/2022 18:36
3865,2004-11-28,Thomasville,Oregon,29634,400,400,0,8/29/2021 19:13,10/30/2021 15:44
3866,1973-11-14,Thomasville,Pennsylvania,29634,580,1080,500,8/29/2021 19:14,4/29/2022 16:26
3867,1952-05-20,Thomasville,Rhode Island,29634,550,550,0,8/29/2021 19:14,10/13/2021 19:01
3868,1993-02-21,Thomasville,South Carolina,29634,1700,1700,0,8/29/2021 19:15,3/17/2022 12:06
3869,1982-06-01,Thomasville,South Dakota,29634,760,760,0,8/29/2021 19:17,4/8/2022 14:47
3870,2003-02-05,Thomasville,Tennessee,29634,4670,4670,0,8/29/2021 19:20,4/10/2022 14:51
3871,2001-04-18,Thomasville,Texas,29634,2920,3420,500,8/29/2021 19:20,6/26/2022 1:56
3872,2001-02-21,Thomasville,Utah,29634,2810,2810,0,8/29/2021 19:20,4/8/2022 18:54
3873,1950-10-25,Thomasville,Vermont,29634,5980,5980,0,8/29/2021 19:21,6/30/2022 14:06
3874,1962-12-19,Thomasville,Virginia,29634,700,700,0,8/29/2021 19:23,10/30/2021 17:11
3875,1971-02-26,Thomasville,Washington,29634,960,960,0,8/29/2021 19:23,4/19/2022 19:05
3876,2002-09-03,Thomasville,West Virginia,29634,510,510,0,8/29/2021 19:24,6/16/2022 22:25
3877,1999-11-11,Thomasville,Wisconsin,29634,2550,2550,0,8/29/2021 19:25,4/30/2022 18:31
3878,2003-05-15,Thomasville,Wyoming,29634,1250,1750,500,8/29/2021 19:26,2/28/2022 17:06
3879,2001-09-18,Thomasville,Alabama,29634,920,1420,500,8/29/2021 19:27,5/26/2022 0:26
3880,1967-08-06,Thomasville,Alaska,29634,310,810,500,8/29/2021 19:27,6/23/2022 8:07
3881,1959-03-15,Thomasville,Arizona,29634,400,1400,1000,8/29/2021 19:28,1/14/2022 13:49
3882,2003-05-12,Thomasville,Arkansas,29634,4050,4050,0,8/29/2021 19:28,5/3/2022 20:22
3883,2002-11-26,Thomasville,California,29634,2310,2310,0,8/29/2021 19:30,5/4/2022 11:22
3884,1956-05-04,Thomasville,Colorado,29634,5330,5330,0,8/29/2021 19:30,5/3/2022 18:10
3885,1956-06-26,Thomasville,Connecticut,29634,560,560,0,8/29/2021 19:31,5/6/2022 12:27
3886,1965-11-01,Thomasville,Delaware,29634,3465,3465,0,8/29/2021 19:33,5/20/2022 20:02
3887,1984-06-13,Thomasville,District of Columbia,29634,770,770,0,8/29/2021 19:33,5/5/2022 21:37
3888,2003-06-10,Thomasville,Florida,29634,660,660,0,8/29/2021 19:35,4/18/2022 13:20
3889,1951-09-25,Thomasville,Georgia,29634,1310,1310,0,8/29/2021 19:35,3/2/2022 18:50
3890,1999-05-25,Thomasville,Hawaii,29634,9150,9150,0,8/29/2021 19:36,6/11/2022 11:18
3891,2003-04-07,Thomasville,Idaho,29634,950,1450,500,8/29/2021 19:36,3/25/2022 17:14
3892,1977-04-16,Thomasville,Illinois,29634,450,450,0,8/29/2021 19:38,1/17/2022 12:44
3893,1973-02-19,Thomasville,Indiana,29634,1020,1020,0,8/29/2021 19:40,4/8/2022 12:51
3894,1986-12-10,Thomasville,Iowa,29634,600,600,0,8/29/2021 19:42,1/23/2022 19:22
3895,1977-09-05,Thomasville,Kansas,29634,4020,4020,0,8/29/2021 19:42,4/19/2022 18:29
3896,1978-10-19,Thomasville,Kentucky,29634,1000,1000,0,8/29/2021 19:43,3/2/2022 20:42
3897,1974-11-06,Thomasville,Louisiana,29634,300,300,0,8/29/2021 19:44,1/12/2022 11:02
3898,1992-03-03,Thomasville,Maine,29634,500,500,0,8/29/2021 19:44,1/14/2022 2:09
3899,2003-02-08,Thomasville,Maryland,29634,1680,1680,0,8/29/2021 19:44,4/19/2022 16:38
3900,1994-03-11,Thomasville,Massachusetts,29634,550,550,0,8/29/2021 19:44,12/1/2021 17:05
3901,1977-07-10,Thomasville,Michigan,29634,500,500,0,8/29/2021 19:44,3/16/2022 19:08
3902,2000-09-14,Thomasville,Minnesota,29634,1270,1270,0,8/29/2021 19:45,4/18/2022 18:01
3903,1960-05-10,Thomasville,Mississippi,29634,300,300,0,8/29/2021 19:45,3/15/2022 18:25
3904,1967-05-10,Thomasville,Missouri,29634,1860,1860,0,8/29/2021 19:46,5/7/2022 15:47
3905,1955-09-08,Thomasville,Montana,29634,450,450,0,8/29/2021 19:47,1/22/2022 19:10
3906,1988-02-20,Thomasville,Nebraska,29634,3100,4100,1000,8/29/2021 19:49,4/4/2022 8:50
3907,1959-06-22,Thomasville,Nevada,29634,320,320,0,8/29/2021 19:50,4/18/2022 18:12
3908,1952-10-22,Thomasville,New Hampshire,29634,300,300,0,8/29/2021 19:50,1/12/2022 19:14
3909,2001-07-04,Thomasville,New Jersey,29634,1300,1300,0,8/29/2021 19:50,3/2/2022 20:01
3910,1989-05-05,Thomasville,New Mexico,29634,1900,1900,0,8/29/2021 19:51,2/26/2022 18:37
3911,1973-03-02,Thomasville,New York,29634,400,400,0,8/29/2021 19:51,2/12/2022 15:37
3912,1993-02-14,Thomasville,North Carolina,29634,950,950,0,8/29/2021 19:52,2/24/2022 22:35
3913,1954-10-03,Thomasville,North Dakota,29634,650,650,0,8/29/2021 19:52,2/26/2022 20:40
3914,1979-01-19,Thomasville,Ohio,29634,1050,1050,0,8/29/2021 19:54,1/12/2022 19:12
3915,1955-12-21,Thomasville,Oklahoma,29634,1910,2910,1000,8/29/2021 19:55,5/3/2022 17:45
3916,1988-02-14,Thomasville,Oregon,29634,1210,1210,0,8/29/2021 19:55,4/9/2022 16:12
3917,1952-05-05,Thomasville,Pennsylvania,29634,450,450,0,8/29/2021 19:59,10/26/2021 12:07
3918,2002-12-06,Thomasville,Rhode Island,29634,5920,5920,0,8/29/2021 19:59,5/29/2022 10:06
3919,1964-07-07,Thomasville,South Carolina,29634,300,300,0,8/29/2021 20:17,2/22/2022 13:35
3920,1965-01-15,Thomasville,South Dakota,29634,2890,2890,0,8/29/2021 20:36,5/23/2022 10:15
3921,2005-09-25,Thomasville,Tennessee,29634,3130,3130,0,8/29/2021 20:53,6/30/2022 6:51
3922,1992-02-16,Thomasville,Texas,29634,900,900,0,8/29/2021 21:01,1/22/2022 2:31
3923,1962-12-09,Thomasville,Utah,29634,410,410,0,8/29/2021 21:46,4/13/2022 10:09
3924,1983-07-27,Thomasville,Vermont,29634,1310,1310,0,8/29/2021 22:09,5/3/2022 17:51
3925,1952-10-05,Thomasville,Virginia,29634,750,750,0,8/29/2021 22:12,1/12/2022 18:54
3926,1979-08-24,Thomasville,Washington,29634,300,300,0,8/29/2021 22:36,1/22/2022 20:10
3927,1968-11-15,Thomasville,West Virginia,29634,310,310,0,8/29/2021 22:40,4/25/2022 23:36
3928,1969-09-18,Thomasville,Wisconsin,29634,8345,8345,0,8/29/2021 23:05,4/19/2022 18:14
3929,1985-12-18,Thomasville,Wyoming,29634,870,870,0,8/30/2021 0:35,5/31/2022 18:59
3930,1989-05-28,Thomasville,Alabama,29634,910,910,0,8/30/2021 7:35,4/16/2022 12:02
3931,1956-03-12,Thomasville,Alaska,29634,500,500,0,8/30/2021 7:35,2/26/2022 18:57
3932,2003-11-06,Thomasville,Arizona,29634,1660,1660,0,8/30/2021 8:41,3/27/2022 16:27
3933,2004-01-12,Thomasville,Arkansas,29634,1100,1100,0,8/30/2021 10:27,1/22/2022 19:58
3934,1985-04-26,Thomasville,California,29634,300,300,0,8/30/2021 10:37,11/30/2021 11:50
3935,1977-09-05,Thomasville,Colorado,29634,350,350,0,8/30/2021 10:40,2/19/2022 12:08
3936,1999-12-17,Thomasville,Connecticut,29634,1410,1410,0,8/30/2021 10:55,6/8/2022 16:08
3937,1955-06-09,Thomasville,Delaware,29634,450,450,0,8/30/2021 10:58,3/1/2022 13:44
3938,1990-08-17,Thomasville,District of Columbia,29634,770,770,0,8/30/2021 11:02,5/7/2022 16:20
3939,2004-01-13,Thomasville,Florida,29634,440,440,0,8/30/2021 11:03,6/7/2022 19:38
3940,1978-04-01,Thomasville,Georgia,29634,1060,1060,0,8/30/2021 11:03,6/12/2022 17:00
3941,1985-05-27,Thomasville,Hawaii,29634,630,630,0,8/30/2021 11:06,5/8/2022 17:01
3942,1986-06-27,Thomasville,Idaho,29634,2160,2160,0,8/30/2021 11:06,4/9/2022 13:13
3943,1970-11-22,Thomasville,Illinois,29634,1220,2220,1000,8/30/2021 11:11,5/3/2022 17:35
3944,1960-09-14,Thomasville,Indiana,29634,300,300,0,8/30/2021 11:27,3/8/2022 14:05
3945,1985-09-08,Thomasville,Iowa,29634,1220,1220,0,8/30/2021 11:36,4/18/2022 11:27
3946,1967-12-17,Thomasville,Kansas,29634,400,400,0,8/30/2021 11:40,1/22/2022 18:27
3947,2001-08-23,Thomasville,Kentucky,29634,300,300,0,8/30/2021 11:51,8/30/2021 11:59
3948,2001-07-06,Thomasville,Louisiana,29634,300,300,0,8/30/2021 11:51,12/4/2021 21:37
3949,1956-05-01,Thomasville,Maine,29634,300,300,0,8/30/2021 11:52,12/1/2021 11:26
3950,1984-07-17,Thomasville,Maryland,29634,850,850,0,8/30/2021 11:55,3/5/2022 15:00
3951,1999-10-08,Thomasville,Massachusetts,29634,410,410,0,8/30/2021 12:02,5/4/2022 21:16
3952,1990-12-01,Thomasville,Michigan,29634,500,500,0,8/30/2021 12:03,1/22/2022 18:49
3953,1968-06-24,Thomasville,Minnesota,29634,400,400,0,8/30/2021 12:05,11/13/2021 18:03
3954,1985-11-11,Thomasville,Mississippi,29634,460,460,0,8/30/2021 12:05,4/11/2022 18:02
3955,1979-06-23,Thomasville,Missouri,29634,430,430,0,8/30/2021 12:06,4/17/2022 12:08
3956,1953-05-22,Thomasville,Montana,29634,850,850,0,8/30/2021 12:06,2/28/2022 17:27
3957,1974-10-15,Thomasville,Nebraska,29634,1250,1250,0,8/30/2021 12:08,3/2/2022 20:40
3958,1974-12-08,Thomasville,Nevada,29634,310,310,0,8/30/2021 12:08,4/15/2022 14:51
3959,1985-10-19,Thomasville,New Hampshire,29634,450,450,0,8/30/2021 12:12,1/12/2022 19:12
3960,1951-12-03,Thomasville,New Jersey,29634,350,350,0,8/30/2021 12:14,2/12/2022 20:09
3961,1988-09-26,Thomasville,New Mexico,29634,1980,1980,0,8/30/2021 12:17,7/1/2022 8:27
3962,1981-01-02,Thomasville,New York,29634,650,650,0,8/30/2021 12:17,4/6/2022 9:53
3963,1970-08-14,Thomasville,North Carolina,29634,1080,1080,0,8/30/2021 12:19,5/11/2022 14:30
3964,2002-04-01,Thomasville,North Dakota,29634,300,300,0,8/30/2021 12:20,3/1/2022 23:15
3965,1977-01-09,Thomasville,Ohio,29634,900,900,0,8/30/2021 12:20,3/2/2022 21:08
3966,1956-07-19,Thomasville,Oklahoma,29634,2140,2140,0,8/30/2021 12:21,5/26/2022 20:06
3967,1952-04-28,Thomasville,Oregon,29634,600,600,0,8/30/2021 12:22,11/13/2021 19:20
3968,1977-05-18,Thomasville,Pennsylvania,29634,800,800,0,8/30/2021 12:23,3/23/2022 9:00
3969,1976-04-08,Thomasville,Rhode Island,29634,1000,1000,0,8/30/2021 12:26,2/26/2022 19:11
3970,1973-03-23,Thomasville,South Carolina,29634,270,770,500,8/30/2021 12:27,5/6/2022 22:03
3971,1959-06-14,Thomasville,South Dakota,29634,1620,1620,0,8/30/2021 12:31,6/24/2022 23:14
3972,1989-01-06,Thomasville,Tennessee,29634,700,700,0,8/30/2021 12:33,1/12/2022 19:08
3973,1995-02-27,Thomasville,Texas,29634,1260,1260,0,8/30/2021 12:33,4/20/2022 22:46
3974,1998-09-02,Thomasville,Utah,29634,310,310,0,8/30/2021 12:35,4/14/2022 12:25
3975,1967-10-27,Thomasville,Vermont,29634,1150,1150,0,8/30/2021 12:37,2/27/2022 14:36
3976,1973-12-12,Thomasville,Virginia,29634,420,420,0,8/30/2021 12:39,5/6/2022 1:01
3977,1992-06-15,Thomasville,Washington,29634,500,1000,500,8/30/2021 12:41,3/25/2022 16:54
3978,1956-01-02,Thomasville,West Virginia,29634,3000,3000,0,8/30/2021 12:45,1/26/2022 11:15
3979,1959-04-26,Thomasville,Wisconsin,29634,1070,1070,0,8/30/2021 12:45,3/25/2022 18:05
3980,2003-07-01,Thomasville,Wyoming,29634,310,310,0,8/30/2021 12:50,4/10/2022 21:24
3981,2002-08-30,Thomasville,Alabama,29634,1100,1100,0,8/30/2021 12:50,4/5/2022 13:43
3982,2002-09-01,Thomasville,Alaska,29634,750,750,0,8/30/2021 12:51,2/10/2022 12:32
3983,1962-03-19,Thomasville,Arizona,29634,1100,1100,0,8/30/2021 12:51,1/22/2022 20:34
3984,1995-12-23,Thomasville,Arkansas,29634,50,550,500,8/30/2021 12:52,1/22/2022 18:39
3985,1983-09-16,Thomasville,California,29634,1050,1050,0,8/30/2021 12:53,1/22/2022 18:44
3986,2001-11-24,Thomasville,Colorado,29634,390,890,500,8/30/2021 12:55,4/12/2022 18:49
3987,2002-05-08,Thomasville,Connecticut,29634,2790,3290,500,8/30/2021 12:55,5/3/2022 20:17
3988,1956-04-28,Thomasville,Delaware,29634,2520,2520,0,8/30/2021 12:57,6/26/2022 15:54
3989,1993-10-15,Thomasville,District of Columbia,29634,1820,1820,0,8/30/2021 12:57,4/9/2022 10:15
3990,1973-04-17,Thomasville,Florida,29634,2870,2870,0,8/30/2021 12:57,7/1/2022 5:37
3991,1997-06-27,Thomasville,Georgia,29634,460,460,0,8/30/2021 13:01,4/15/2022 19:28
3992,1983-12-17,Thomasville,Hawaii,29634,1660,1660,0,8/30/2021 13:03,4/30/2022 12:08
3993,1997-06-14,Thomasville,Idaho,29634,2010,2010,0,8/30/2021 13:10,4/9/2022 20:31
3994,1996-02-28,Thomasville,Illinois,29634,450,450,0,8/30/2021 13:11,3/19/2022 16:00
3995,1993-07-13,Thomasville,Indiana,29634,4110,4110,0,8/30/2021 13:12,4/5/2022 13:00
3996,1995-12-13,Thomasville,Iowa,29634,3505,3505,0,8/30/2021 13:13,3/28/2022 16:06
3997,2003-04-19,Oakwood,Ohio,45419,2070,2570,500,8/30/2021 13:13,6/1/2022 23:38
3998,1953-01-24,Thomasville,Kansas,29634,310,310,0,8/30/2021 13:14,4/22/2022 17:16
3999,1962-02-10,Thomasville,Kentucky,29634,650,650,0,8/30/2021 13:20,2/26/2022 18:57
4000,2001-04-26,Thomasville,Louisiana,29634,350,350,0,8/30/2021 13:33,2/26/2022 0:47
4001,1958-07-05,Thomasville,Maine,29634,650,650,0,8/30/2021 13:41,3/28/2022 15:33
4002,2003-10-15,Thomasville,Maryland,29634,1000,1000,0,8/30/2021 13:43,3/30/2022 18:55
4003,2000-06-25,Thomasville,Massachusetts,29634,1080,1080,0,8/30/2021 13:53,4/11/2022 14:53
4004,1992-02-11,Thomasville,Michigan,29634,700,700,0,8/30/2021 13:57,2/22/2022 19:00
4005,1999-01-21,Thomasville,Minnesota,29634,2010,2010,0,8/30/2021 13:59,4/16/2022 13:52
4006,1999-05-06,Thomasville,Mississippi,29634,6710,6710,0,8/30/2021 13:59,6/5/2022 9:51
4007,1971-10-13,Thomasville,Missouri,29634,910,910,0,8/30/2021 14:19,4/8/2022 12:47
4008,1970-03-02,Thomasville,Montana,29634,1400,1400,0,8/30/2021 14:21,3/29/2022 7:16
4009,1963-02-17,Thomasville,Nebraska,29634,360,360,0,8/30/2021 14:21,4/7/2022 22:15
4010,1975-07-20,Thomasville,Nevada,29634,3000,3000,0,8/30/2021 14:27,6/30/2022 0:06
4011,1996-11-29,Thomasville,New Hampshire,29634,400,400,0,8/30/2021 14:31,11/30/2021 22:36
4012,1995-12-27,Thomasville,New Jersey,29634,300,300,0,8/30/2021 14:34,10/30/2021 16:04
4013,1978-12-20,Thomasville,New Mexico,29634,1200,1200,0,8/30/2021 14:35,12/22/2021 20:33
4014,1966-02-05,Thomasville,New York,29634,1300,1300,0,8/30/2021 14:37,2/23/2022 22:28
4015,1999-05-28,Thomasville,North Carolina,29634,960,960,0,8/30/2021 14:40,5/11/2022 13:06
4016,1998-03-02,Thomasville,North Dakota,29634,2000,2000,0,8/30/2021 14:52,3/16/2022 10:42
4017,1988-06-09,Thomasville,Ohio,29634,510,510,0,8/30/2021 14:53,5/4/2022 13:12
4018,1986-03-11,Thomasville,Oklahoma,29634,1040,2040,1000,8/30/2021 14:56,6/25/2022 2:07
4019,2002-07-01,Manhattan beach ,California,90266,400,400,0,8/30/2021 15:00,3/2/2022 21:05
4020,2005-10-13,Thomasville,Oregon,29634,800,800,0,8/30/2021 15:00,3/13/2022 8:51
4021,1997-03-05,Thomasville,Pennsylvania,29634,400,400,0,8/30/2021 15:01,3/9/2022 9:57
4022,2005-07-06,Thomasville,Rhode Island,29634,300,300,0,8/30/2021 15:04,9/10/2021 11:31
4023,1961-08-01,Thomasville,South Carolina,29634,1100,1100,0,8/30/2021 15:06,3/16/2022 19:32
4024,1953-11-14,Thomasville,South Dakota,29634,300,300,0,8/30/2021 15:07,3/16/2022 19:08
4025,1999-04-01,Thomasville,Tennessee,29634,800,800,0,8/30/2021 15:11,2/19/2022 12:52
4026,1999-07-01,Thomasville,Texas,29634,2320,2320,0,8/30/2021 15:16,5/5/2022 12:23
4027,1999-07-26,Thomasville,Utah,29634,1500,1500,0,8/30/2021 15:20,4/15/2022 14:08
4028,1993-10-23,Thomasville,Vermont,29634,300,300,0,8/30/2021 15:20,1/11/2022 7:35
4029,1952-09-20,Thomasville,Virginia,29634,1610,1610,0,8/30/2021 15:21,3/23/2022 9:06
4030,1957-11-06,Thomasville,Washington,29634,300,300,0,8/30/2021 15:27,8/30/2021 15:27
4031,1973-02-16,Thomasville,West Virginia,29634,300,300,0,8/30/2021 15:34,11/13/2021 20:16
4032,1998-11-08,Thomasville,Wisconsin,29634,450,450,0,8/30/2021 15:35,3/16/2022 14:03
4033,1953-01-01,Thomasville,Wyoming,29634,650,650,0,8/30/2021 15:42,3/16/2022 19:36
4034,1950-09-25,Thomasville,Alabama,29634,360,360,0,8/30/2021 15:45,4/15/2022 16:19
4035,1994-09-19,Thomasville,Alaska,29634,400,400,0,8/30/2021 15:45,1/22/2022 19:27
4036,2000-05-24,Thomasville,Arizona,29634,400,400,0,8/30/2021 15:48,2/26/2022 19:12
4037,1995-03-02,Thomasville,Arkansas,29634,300,300,0,8/30/2021 15:48,3/14/2022 7:16
4038,1997-04-25,Thomasville,California,29634,450,450,0,8/30/2021 15:49,11/27/2021 20:38
4039,1993-06-10,Thomasville,Colorado,29634,300,300,0,8/30/2021 15:57,11/27/2021 18:15
4040,1992-03-08,Thomasville,Connecticut,29634,1590,1590,0,8/30/2021 16:04,6/30/2022 5:42
4041,1998-08-08,Thomasville,Delaware,29634,570,5570,5000,8/30/2021 16:13,5/11/2022 17:28
4042,2000-04-28,Thomasville,District of Columbia,29634,410,410,0,8/30/2021 16:20,5/20/2022 11:35
4043,2004-06-23,Thomasville,Florida,29634,1490,1490,0,8/30/2021 16:22,5/19/2022 1:49
4044,1950-04-24,Thomasville,Georgia,29634,300,300,0,8/30/2021 16:24,11/30/2021 18:18
4045,2000-05-17,Thomasville,Hawaii,29634,920,920,0,8/30/2021 16:24,4/8/2022 11:31
4046,1952-11-11,Thomasville,Idaho,29634,900,1400,500,8/30/2021 16:25,3/16/2022 21:18
4047,1954-07-03,Thomasville,Illinois,29634,350,350,0,8/30/2021 16:25,3/25/2022 18:03
4048,1952-05-25,Thomasville,Indiana,29634,300,300,0,8/30/2021 16:25,3/2/2022 12:40
4049,1998-01-28,Thomasville,Iowa,29634,800,800,0,8/30/2021 16:27,3/5/2022 14:37
4050,1999-09-29,Thomasville,Kansas,29634,450,450,0,8/30/2021 16:27,11/30/2021 18:44
4051,1985-10-21,Thomasville,Kentucky,29634,610,610,0,8/30/2021 16:35,4/15/2022 15:33
4052,1970-05-27,Thomasville,Louisiana,29634,850,850,0,8/30/2021 16:36,2/19/2022 11:50
4053,1972-03-15,Thomasville,Maine,29634,960,960,0,8/30/2021 16:38,4/8/2022 12:50
4054,1979-02-05,Thomasville,Maryland,29634,1150,1650,500,8/30/2021 16:39,3/16/2022 13:44
4055,2003-05-21,Thomasville,Massachusetts,29634,1100,1100,0,8/30/2021 16:39,3/27/2022 11:41
4056,1976-03-15,Thomasville,Michigan,29634,300,300,0,8/30/2021 16:43,4/6/2022 12:03
4057,1978-07-24,Thomasville,Minnesota,29634,310,310,0,8/30/2021 16:43,4/10/2022 13:05
4058,2000-08-12,Thomasville,Mississippi,29634,400,400,0,8/30/2021 16:44,4/6/2022 10:52
4059,1989-07-18,Thomasville,Missouri,29634,400,400,0,8/30/2021 16:45,4/6/2022 12:03
4060,2002-12-16,Thomasville,Montana,29634,1610,1610,0,8/30/2021 16:47,5/6/2022 14:54
4061,1999-04-29,Thomasville,Nebraska,29634,2280,2280,0,8/30/2021 16:48,5/11/2022 9:39
4062,1988-06-25,Thomasville,Nevada,29634,720,720,0,8/30/2021 16:50,5/11/2022 13:21
4063,1996-11-06,Thomasville,New Hampshire,29634,820,820,0,8/30/2021 16:50,5/4/2022 22:57
4064,2004-02-16,Thomasville,New Jersey,29634,650,650,0,8/30/2021 16:54,2/20/2022 23:24
4065,1957-03-17,Thomasville,New Mexico,29634,300,300,0,8/30/2021 17:00,1/12/2022 16:07
4066,1987-05-06,Thomasville,New York,29634,1080,1080,0,8/30/2021 17:02,4/20/2022 16:50
4067,1960-04-14,Thomasville,North Carolina,29634,3220,3220,0,8/30/2021 17:06,4/24/2022 12:38
4068,1963-02-21,Thomasville,North Dakota,29634,1520,1520,0,8/30/2021 17:11,6/16/2022 14:40
4069,2001-01-25,Thomasville,Ohio,29634,400,400,0,8/30/2021 17:19,3/18/2022 19:51
4070,1970-09-01,Thomasville,Oklahoma,29634,300,300,0,8/30/2021 17:21,12/28/2021 19:00
4071,1964-06-23,Thomasville,Oregon,29634,630,630,0,8/30/2021 17:31,5/20/2022 15:41
4072,1962-06-06,Thomasville,Pennsylvania,29634,670,670,0,8/30/2021 17:32,6/27/2022 10:23
4073,1996-12-08,Thomasville,Rhode Island,29634,350,350,0,8/30/2021 17:32,11/29/2021 17:20
4074,1980-08-20,Thomasville,South Carolina,29634,300,300,0,8/30/2021 17:33,3/15/2022 22:56
4075,1985-08-24,Thomasville,South Dakota,29634,300,300,0,8/30/2021 17:33,3/2/2022 21:07
4076,1989-03-28,Thomasville,Tennessee,29634,810,810,0,8/30/2021 17:35,4/30/2022 19:49
4077,1968-11-21,Thomasville,Texas,29634,1000,1000,0,8/30/2021 17:45,3/25/2022 17:49
4078,1993-11-23,Thomasville,Utah,29634,1060,1060,0,8/30/2021 17:53,4/18/2022 18:01
4079,1971-02-09,Thomasville,Vermont,29634,600,600,0,8/30/2021 17:54,2/26/2022 19:22
4080,1968-06-03,Thomasville,Virginia,29634,870,870,0,8/30/2021 17:55,5/10/2022 21:09
4081,1994-07-24,Thomasville,Washington,29634,1110,1110,0,8/30/2021 18:00,4/27/2022 22:18
4082,1990-10-02,Thomasville,West Virginia,29634,300,300,0,8/30/2021 18:00,2/12/2022 15:35
4083,1976-07-14,Thomasville,Wisconsin,29634,1000,1000,0,8/30/2021 18:01,1/12/2022 18:59
4084,1972-06-06,Thomasville,Wyoming,29634,1100,1100,0,8/30/2021 18:01,3/3/2022 13:25
4085,1972-02-27,Thomasville,Alabama,29634,300,300,0,8/30/2021 18:02,3/22/2022 12:32
4086,1966-10-15,Thomasville,Alaska,29634,350,350,0,8/30/2021 18:12,10/2/2021 7:56
4087,1988-08-03,Thomasville,Arizona,29634,650,650,0,8/30/2021 18:17,3/15/2022 12:23
4088,1970-02-14,Thomasville,Arkansas,29634,350,350,0,8/30/2021 18:25,3/14/2022 10:10
4089,1970-04-23,Thomasville,California,29634,300,300,0,8/30/2021 18:38,4/6/2022 10:58
4090,1974-09-11,Thomasville,Colorado,29634,1030,1030,0,8/30/2021 18:48,4/21/2022 21:46
4091,1997-10-01,Thomasville,Connecticut,29634,300,300,0,8/30/2021 18:49,3/1/2022 18:31
4092,1986-12-07,Thomasville,Delaware,29634,1250,1250,0,8/30/2021 18:51,3/2/2022 20:51
4093,1951-02-16,Thomasville,District of Columbia,29634,1700,1700,0,8/30/2021 18:52,3/19/2022 14:53
4094,1976-04-16,Thomasville,Florida,29634,300,300,0,8/30/2021 18:52,3/2/2022 20:51
4095,1984-08-18,Thomasville,Georgia,29634,500,500,0,8/30/2021 18:54,3/17/2022 12:18
4096,1995-05-25,winston salem ,North Carolina,27101,1250,1250,0,8/30/2021 18:59,3/2/2022 23:02
4097,1995-03-22,Thomasville,Hawaii,29634,2050,2050,0,8/30/2021 19:02,3/2/2022 22:30
4098,1997-08-10,Thomasville,Idaho,29634,2000,2000,0,8/30/2021 19:05,3/10/2022 17:47
4099,1954-08-28,Thomasville,Illinois,29634,600,600,0,8/30/2021 19:06,2/18/2022 12:33
4100,1991-01-25,Thomasville,Indiana,29634,300,300,0,8/30/2021 19:08,1/12/2022 19:05
4101,1995-09-27,Thomasville,Iowa,29634,0,500,500,8/30/2021 19:11,12/1/2021 15:06
4102,1978-02-02,Thomasville,Kansas,29634,300,300,0,8/30/2021 19:16,12/1/2021 9:43
4103,1984-08-24,Thomasville,Kentucky,29634,2600,2600,0,8/30/2021 19:17,2/25/2022 17:02
4104,1974-11-25,Thomasville,Louisiana,29634,970,970,0,8/30/2021 19:17,2/12/2022 13:10
4105,2003-03-25,Thomasville,Maine,29634,400,400,0,8/30/2021 19:19,1/22/2022 15:47
4106,1984-10-14,Thomasville,Maryland,29634,650,650,0,8/30/2021 19:20,1/22/2022 19:02
4107,1957-02-07,Thomasville,Massachusetts,29634,3300,3300,0,8/30/2021 19:21,3/5/2022 22:19
4108,1982-10-20,Thomasville,Michigan,29634,450,450,0,8/30/2021 19:28,2/27/2022 16:00
4109,1981-03-05,Thomasville,Minnesota,29634,750,750,0,8/30/2021 19:41,3/16/2022 20:20
4110,1965-06-15,Thomasville,Mississippi,29634,410,910,500,8/30/2021 19:44,5/8/2022 9:21
4111,1986-01-21,Thomasville,Missouri,29634,10,1010,1000,8/30/2021 19:49,5/3/2022 13:03
4112,1969-06-17,Thomasville,Montana,29634,320,1320,1000,8/30/2021 19:50,4/29/2022 18:07
4113,1961-11-09,Thomasville,Nebraska,29634,1350,7350,6000,8/30/2021 19:50,6/26/2022 10:15
4114,1963-09-16,Thomasville,Nevada,29634,760,760,0,8/30/2021 19:51,4/8/2022 21:39
4115,1953-06-14,Thomasville,New Hampshire,29634,2980,2980,0,8/30/2021 19:52,6/21/2022 18:36
4116,1989-08-16,Thomasville,New Jersey,29634,870,870,0,8/30/2021 19:52,4/6/2022 14:27
4117,1981-08-28,Thomasville,New Mexico,29634,1690,1690,0,8/30/2021 19:53,1/28/2022 17:21
4118,1955-12-20,Thomasville,New York,29634,300,300,0,8/30/2021 19:56,11/30/2021 18:14
4119,1994-05-24,Thomasville,North Carolina,29634,450,450,0,8/30/2021 19:56,9/3/2021 19:25
4120,1951-07-07,Thomasville,North Dakota,29634,300,300,0,8/30/2021 19:57,1/22/2022 18:48
4121,2021-07-20,Thomasville,Ohio,29634,300,800,500,8/30/2021 19:57,1/22/2022 18:49
4122,1960-06-10,Thomasville,Oklahoma,29634,2420,2420,0,8/30/2021 19:57,6/11/2022 9:21
4123,2001-04-27,Thomasville,Oregon,29634,200,700,500,8/30/2021 19:57,3/27/2022 19:54
4124,1952-07-02,Thomasville,Pennsylvania,29634,400,400,0,8/30/2021 19:58,11/15/2021 11:51
4125,1962-08-18,Thomasville,Rhode Island,29634,300,300,0,8/30/2021 19:59,11/27/2021 21:31
4126,1991-05-20,Thomasville,South Carolina,29634,2210,2710,500,8/30/2021 19:59,5/12/2022 16:35
4127,2001-05-01,Thomasville,South Dakota,29634,2960,2960,0,8/30/2021 20:00,6/7/2022 20:23
4128,2003-07-09,Thomasville,Tennessee,29634,2170,2170,0,8/30/2021 20:01,4/19/2022 20:04
4129,1988-07-15,Thomasville,Texas,29634,750,750,0,8/30/2021 20:03,1/25/2022 12:08
4130,2002-08-17,Thomasville,Utah,29634,2490,2490,0,8/30/2021 20:05,4/23/2022 17:32
4131,1997-12-20,Thomasville,Vermont,29634,3000,3000,0,8/30/2021 20:05,6/24/2022 11:49
4132,1985-11-02,Thomasville,Virginia,29634,1350,1350,0,8/30/2021 20:06,3/14/2022 10:34
4133,1990-09-21,Thomasville,Washington,29634,550,550,0,8/30/2021 20:07,2/1/2022 20:00
4134,1991-04-23,Thomasville,West Virginia,29634,300,300,0,8/30/2021 20:10,1/26/2022 14:47
4135,1990-11-05,Thomasville,Wisconsin,29634,800,800,0,8/30/2021 20:21,11/12/2021 18:43
4136,1956-08-03,Thomasville,Wyoming,29634,1150,1150,0,8/30/2021 20:30,2/23/2022 13:50
4137,1997-06-22,Thomasville,Alabama,29634,330,330,0,8/30/2021 20:31,5/3/2022 18:03
4138,1999-11-04,Thomasville,Alaska,29634,650,650,0,8/30/2021 20:32,1/12/2022 18:54
4139,2003-06-23,Thomasville,Arizona,29634,420,420,0,8/30/2021 20:34,5/13/2022 17:39
4140,1994-09-26,Thomasville,Arkansas,29634,300,300,0,8/30/2021 20:35,3/27/2022 23:46
4141,1988-03-05,Thomasville,California,29634,1190,1190,0,8/30/2021 20:37,6/28/2022 22:02
4142,1968-08-25,Thomasville,Colorado,29634,1300,1300,0,8/30/2021 20:46,3/24/2022 18:03
4143,1991-03-12,Thomasville,Connecticut,29634,310,310,0,8/30/2021 20:49,6/13/2022 20:36
4144,2003-07-01,Thomasville,Delaware,29634,3080,3080,0,8/30/2021 20:49,4/18/2022 19:47
4145,1954-10-07,Thomasville,District of Columbia,29634,430,430,0,8/30/2021 20:50,6/29/2022 11:23
4146,2004-10-28,Thomasville,Florida,29634,900,900,0,8/30/2021 20:52,1/27/2022 18:47
4147,1961-01-25,Thomasville,Georgia,29634,300,300,0,8/30/2021 20:52,11/30/2021 18:56
4148,1996-02-09,Winston-Salem,North Carolina,27106,630,1630,1000,8/30/2021 20:54,3/30/2022 16:43
4149,1952-04-21,Thomasville,Hawaii,29634,760,760,0,8/30/2021 20:55,5/21/2022 23:07
4150,2021-11-27,Thomasville,Idaho,29634,860,860,0,8/30/2021 20:57,4/19/2022 14:21
4151,2002-12-20,Thomasville,Illinois,29634,310,310,0,8/30/2021 20:57,6/22/2022 17:53
4152,1987-08-28,Thomasville,Indiana,29634,600,600,0,8/30/2021 20:57,2/19/2022 18:24
4153,1999-04-23,Thomasville,Iowa,29634,2370,2370,0,8/30/2021 21:00,4/19/2022 18:17
4154,1967-03-22,Thomasville,Kansas,29634,800,800,0,8/30/2021 21:02,2/26/2022 19:05
4155,2003-11-01,Thomasville,Kentucky,29634,420,420,0,8/30/2021 21:02,5/31/2022 11:26
4156,1958-05-04,Thomasville,Louisiana,29634,1580,1580,0,8/30/2021 21:06,4/16/2022 14:20
4157,2000-02-13,Thomasville,Maine,29634,1270,1270,0,8/30/2021 21:10,5/11/2022 13:20
4158,1994-08-31,Thomasville,Maryland,29634,2030,2030,0,8/30/2021 21:14,6/18/2022 18:49
4159,1995-02-04,Thomasville,Massachusetts,29634,1020,1020,0,8/30/2021 21:16,4/8/2022 19:25
4160,1968-02-10,Thomasville,Michigan,29634,720,720,0,8/30/2021 21:17,4/26/2022 18:15
4161,1988-05-21,Thomasville,Minnesota,29634,950,950,0,8/30/2021 21:18,1/24/2022 18:32
4162,1998-11-11,Thomasville,Mississippi,29634,2250,2250,0,8/30/2021 21:20,5/1/2022 15:06
4163,1999-07-01,Thomasville,Missouri,29634,920,920,0,8/30/2021 21:25,4/15/2022 19:28
4164,2001-09-04,Thomasville,Montana,29634,1830,1830,0,8/30/2021 21:25,1/18/2022 22:06
4165,1975-12-23,Thomasville,Nebraska,29634,300,300,0,8/30/2021 21:31,3/2/2022 15:07
4166,2003-07-29,Thomasville,Nevada,29634,400,400,0,8/30/2021 21:32,1/22/2022 19:59
4167,1988-01-28,Thomasville,New Hampshire,29634,300,300,0,8/30/2021 21:34,2/19/2022 13:32
4168,1991-12-18,Thomasville,New Jersey,29634,300,300,0,8/30/2021 21:37,3/14/2022 9:01
4169,1971-09-23,Thomasville,New Mexico,29634,1710,1710,0,8/30/2021 21:39,5/3/2022 17:05
4170,2000-04-23,Thomasville,New York,29634,1980,1980,0,8/30/2021 21:41,5/7/2022 0:47
4171,2000-08-02,Thomasville,North Carolina,29634,1560,1560,0,8/30/2021 21:43,4/18/2022 14:51
4172,1953-12-16,Thomasville,North Dakota,29634,1150,1150,0,8/30/2021 21:49,2/28/2022 16:00
4173,1956-02-27,Thomasville,Ohio,29634,360,360,0,8/30/2021 21:49,5/2/2022 10:02
4174,1978-01-11,Thomasville,Oklahoma,29634,10,510,500,8/30/2021 21:50,4/16/2022 16:44
4175,1994-11-02,Thomasville,Oregon,29634,450,450,0,8/30/2021 21:52,2/26/2022 10:22
4176,1955-11-17,Thomasville,Pennsylvania,29634,1300,1300,0,8/30/2021 22:09,3/5/2022 19:19
4177,1995-09-18,Thomasville,Rhode Island,29634,910,910,0,8/30/2021 22:17,4/26/2022 19:18
4178,1980-11-16,Thomasville,South Carolina,29634,310,310,0,8/30/2021 22:28,5/3/2022 14:44
4179,2001-08-08,Thomasville,South Dakota,29634,310,310,0,8/30/2021 22:29,6/25/2022 14:14
4180,1952-11-09,Thomasville,Tennessee,29634,510,510,0,8/30/2021 22:31,5/9/2022 18:19
4181,1950-07-24,Thomasville,Texas,29634,300,300,0,8/30/2021 22:38,10/30/2021 15:08
4182,1975-08-10,Thomasville,Utah,29634,350,350,0,8/30/2021 22:40,3/17/2022 13:33
4183,2021-08-16,Thomasville,Vermont,29634,850,850,0,8/30/2021 22:46,11/5/2021 11:23
4184,1960-09-24,Thomasville,Virginia,29634,750,750,0,8/30/2021 22:46,2/19/2022 12:06
4185,2003-10-06,Thomasville,Washington,29634,600,1100,500,8/30/2021 22:47,2/24/2022 13:09
4186,1962-07-23,Thomasville,West Virginia,29634,400,900,500,8/30/2021 22:56,1/22/2022 17:45
4187,1963-08-23,Thomasville,Wisconsin,29634,1010,1510,500,8/30/2021 22:57,3/6/2022 23:27
4188,2002-12-19,Thomasville,Wyoming,29634,1200,2200,1000,8/30/2021 22:58,3/2/2022 16:56
4189,1968-11-27,Thomasville,Alabama,29634,310,310,0,8/30/2021 23:30,5/3/2022 13:24
4190,1964-04-09,Thomasville,Alaska,29634,1000,1000,0,8/30/2021 23:42,2/2/2022 2:13
4191,1975-02-05,Thomasville,Arizona,29634,1930,1930,0,8/30/2021 23:46,4/28/2022 15:37
4192,2005-07-22,Thomasville,Arkansas,29634,1620,1620,0,8/30/2021 23:58,4/16/2022 2:32
4193,1982-10-13,Thomasville,California,29634,450,450,0,8/31/2021 4:56,1/28/2022 15:28
4194,1974-04-10,Thomasville,Colorado,29634,950,950,0,8/31/2021 9:10,3/16/2022 18:38
4195,1988-09-10,Thomasville,Connecticut,29634,750,750,0,8/31/2021 9:47,3/28/2022 16:41
4196,1988-02-16,Thomasville,Delaware,29634,700,700,0,8/31/2021 10:13,2/28/2022 14:00
4197,1956-06-18,Thomasville,District of Columbia,29634,970,970,0,8/31/2021 10:24,4/16/2022 22:58
4198,1993-07-09,Thomasville,Florida,29634,1800,1800,0,8/31/2021 10:25,3/13/2022 20:29
4199,1968-10-18,Thomasville,Georgia,29634,310,310,0,8/31/2021 10:26,4/19/2022 13:05
4200,2002-10-21,Duxbury,District of Columbia,2332,800,1800,1000,8/31/2021 10:40,2/1/2022 20:30
4201,1969-11-09,Thomasville,Hawaii,29634,300,300,0,8/31/2021 11:02,4/7/2022 9:59
4202,1970-02-08,Thomasville,Idaho,29634,1150,1150,0,8/31/2021 11:04,1/22/2022 19:44
4203,1997-01-13,Thomasville,Illinois,29634,450,450,0,8/31/2021 11:06,3/26/2022 10:37
4204,1953-04-14,Thomasville,Indiana,29634,1150,1150,0,8/31/2021 11:07,2/10/2022 9:13
4205,1958-08-11,Thomasville,Iowa,29634,1220,1220,0,8/31/2021 11:07,5/2/2022 10:22
4206,1985-04-20,Thomasville,Kansas,29634,450,450,0,8/31/2021 11:09,1/12/2022 10:23
4207,1967-09-18,Thomasville,Kentucky,29634,400,400,0,8/31/2021 11:11,1/17/2022 12:08
4208,1974-10-27,Thomasville,Louisiana,29634,800,800,0,8/31/2021 11:15,3/12/2022 10:45
4209,1971-08-28,Thomasville,Maine,29634,100,600,500,8/31/2021 11:18,1/12/2022 15:33
4210,1989-02-21,Thomasville,Maryland,29634,350,350,0,8/31/2021 11:19,2/27/2022 16:04
4211,2004-12-11,Thomasville,Massachusetts,29634,360,860,500,8/31/2021 11:25,4/7/2022 19:17
4212,2003-08-13,Thomasville,Michigan,29634,770,770,0,8/31/2021 11:39,4/9/2022 17:37
4213,2000-02-20,Thomasville,Minnesota,29634,300,300,0,8/31/2021 11:40,3/25/2022 18:15
4214,1993-05-08,Thomasville,Mississippi,29634,300,300,0,8/31/2021 11:41,11/13/2021 18:52
4215,1992-07-26,Thomasville,Missouri,29634,300,300,0,8/31/2021 11:44,1/22/2022 19:14
4216,1964-09-26,Thomasville,Montana,29634,550,1050,500,8/31/2021 11:48,2/2/2022 19:20
4217,1958-04-21,Thomasville,Nebraska,29634,750,750,0,8/31/2021 11:55,1/22/2022 14:08
4218,1995-11-15,Thomasville,Nevada,29634,1580,1580,0,8/31/2021 11:58,5/3/2022 13:01
4219,1952-07-08,Thomasville,New Hampshire,29634,300,300,0,8/31/2021 12:03,9/10/2021 21:00
4220,1970-12-12,Thomasville,New Jersey,29634,5895,5895,0,8/31/2021 12:13,4/9/2022 15:24
4221,1976-02-07,Thomasville,New Mexico,29634,1410,1410,0,8/31/2021 12:37,4/8/2022 19:04
4222,1962-08-10,Thomasville,New York,29634,710,710,0,8/31/2021 12:40,4/8/2022 19:05
4223,2003-11-19,Thomasville,North Carolina,29634,3300,3300,0,8/31/2021 12:44,6/29/2022 19:51
4224,1986-10-10,Thomasville,North Dakota,29634,320,320,0,8/31/2021 12:45,4/8/2022 19:06
4225,1987-06-20,Thomasville,Ohio,29634,20,520,500,8/31/2021 12:47,5/11/2022 16:41
4226,1971-01-02,Thomasville,Oklahoma,29634,650,650,0,8/31/2021 12:57,3/29/2022 16:03
4227,1970-08-05,Thomasville,Oregon,29634,600,600,0,8/31/2021 13:04,1/22/2022 20:54
4228,1988-06-20,Thomasville,Pennsylvania,29634,700,700,0,8/31/2021 13:07,10/30/2021 16:46
4229,1994-12-12,Thomasville,Rhode Island,29634,4645,4645,0,8/31/2021 13:09,4/18/2022 11:52
4230,2000-10-22,Thomasville,South Carolina,29634,1580,1580,0,8/31/2021 13:34,5/3/2022 17:37
4231,2002-07-15,Thomasville,South Dakota,29634,450,450,0,8/31/2021 13:38,1/22/2022 19:29
4232,1952-04-11,Thomasville,Tennessee,29634,300,300,0,8/31/2021 13:43,1/12/2022 19:07
4233,1967-12-22,Thomasville,Texas,29634,1000,1000,0,8/31/2021 13:44,1/22/2022 13:35
4234,1994-07-19,Thomasville,Utah,29634,3060,3060,0,8/31/2021 13:55,1/23/2022 13:04
4235,1988-12-14,Thomasville,Vermont,29634,450,450,0,8/31/2021 14:00,1/12/2022 12:53
4236,1981-08-26,Thomasville,Virginia,29634,350,350,0,8/31/2021 14:24,1/26/2022 15:09
4237,1989-06-13,Thomasville,Washington,29634,300,300,0,8/31/2021 14:26,2/23/2022 18:18
4238,1996-02-14,Thomasville,West Virginia,29634,650,650,0,8/31/2021 14:49,2/12/2022 15:01
4239,1969-12-04,Thomasville,Wisconsin,29634,500,500,0,8/31/2021 14:51,1/22/2022 23:03
4240,1996-12-11,Thomasville,Wyoming,29634,1710,1710,0,8/31/2021 14:54,5/11/2022 18:07
4241,2002-06-02,Thomasville,Alabama,29634,4800,4800,0,8/31/2021 14:57,5/11/2022 12:07
4242,1985-11-08,Thomasville,Alaska,29634,460,460,0,8/31/2021 15:00,5/9/2022 18:00
4243,2003-03-05,Thomasville,Arizona,29634,670,670,0,8/31/2021 15:26,5/8/2022 14:11
4244,1957-11-08,Thomasville,Arkansas,29634,300,300,0,8/31/2021 15:28,3/2/2022 22:09
4245,1996-02-09,Thomasville,California,29634,450,450,0,8/31/2021 15:38,1/24/2022 20:30
4246,1955-04-11,Thomasville,Colorado,29634,750,750,0,8/31/2021 16:00,2/26/2022 18:53
4247,1986-08-21,Thomasville,Connecticut,29634,710,4210,3500,8/31/2021 16:01,4/30/2022 10:56
4248,1970-08-03,Thomasville,Delaware,29634,300,300,0,8/31/2021 16:01,11/3/2021 20:03
4249,1973-04-26,Thomasville,District of Columbia,29634,350,350,0,8/31/2021 16:02,1/22/2022 19:46
4250,1998-04-15,Thomasville,Florida,29634,350,350,0,8/31/2021 16:02,11/13/2021 9:04
4251,1992-08-14,Thomasville,Georgia,29634,560,560,0,8/31/2021 16:02,4/8/2022 8:59
4252,1952-08-20,Thomasville,Hawaii,29634,300,300,0,8/31/2021 16:02,1/20/2022 10:57
4253,2002-08-10,Thomasville,Idaho,29634,370,370,0,8/31/2021 16:03,5/11/2022 17:37
4254,1996-12-14,Thomasville,Illinois,29634,960,1960,1000,8/31/2021 16:03,4/8/2022 19:46
4255,1999-09-13,Thomasville,Indiana,29634,300,300,0,8/31/2021 16:03,10/28/2021 10:39
4256,1993-12-21,Thomasville,Iowa,29634,1050,1050,0,8/31/2021 16:03,5/10/2022 14:58
4257,1992-01-15,Thomasville,Kansas,29634,550,550,0,8/31/2021 16:04,3/26/2022 16:06
4258,1953-07-16,Thomasville,Kentucky,29634,300,300,0,8/31/2021 16:04,3/12/2022 22:43
4259,1966-04-12,Thomasville,Louisiana,29634,350,350,0,8/31/2021 16:06,9/6/2021 19:27
4260,1952-03-04,Thomasville,Maine,29634,410,410,0,8/31/2021 16:06,4/8/2022 19:07
4261,1987-12-05,Thomasville,Maryland,29634,2070,5070,3000,8/31/2021 16:08,5/30/2022 13:40
4262,2001-02-09,Thomasville,Massachusetts,29634,330,330,0,8/31/2021 16:08,4/11/2022 14:16
4263,1997-01-09,Thomasville,Michigan,29634,550,550,0,8/31/2021 16:09,2/19/2022 17:41
4264,2005-11-21,Thomasville,Minnesota,29634,300,300,0,8/31/2021 16:10,2/9/2022 9:02
4265,1972-11-10,Thomasville,Mississippi,29634,310,310,0,8/31/2021 16:10,4/22/2022 11:21
4266,1991-05-16,Thomasville,Missouri,29634,300,300,0,8/31/2021 16:11,1/22/2022 14:23
4267,1976-06-26,Thomasville,Montana,29634,700,700,0,8/31/2021 16:12,3/16/2022 9:58
4268,1999-01-21,Winston-Salem,North Carolina,27106,780,780,0,8/31/2021 16:12,6/17/2022 9:21
4269,1954-09-08,Thomasville,Nebraska,29634,920,920,0,8/31/2021 16:13,6/3/2022 9:48
4270,1962-09-20,Thomasville,Nevada,29634,400,400,0,8/31/2021 16:13,12/24/2021 12:51
4271,1990-01-17,Thomasville,New Hampshire,29634,300,300,0,8/31/2021 16:13,10/19/2021 14:26
4272,2004-03-07,Thomasville,New Jersey,29634,2620,2620,0,8/31/2021 16:14,4/18/2022 12:38
4273,1998-12-29,Thomasville,New Mexico,29634,610,610,0,8/31/2021 16:14,6/6/2022 12:41
4274,1950-06-05,Thomasville,New York,29634,350,350,0,8/31/2021 16:17,9/3/2021 18:59
4275,1999-03-26,Thomasville,North Carolina,29634,300,300,0,8/31/2021 16:18,2/25/2022 22:32
4276,1990-09-25,Winston-Salem,North Carolina,27101,500,500,0,8/31/2021 16:18,1/22/2022 18:00
4277,1994-10-03,Thomasville,North Dakota,29634,4920,4920,0,8/31/2021 16:21,3/11/2022 10:29
4278,1971-04-04,Thomasville,Ohio,29634,300,300,0,8/31/2021 16:22,12/1/2021 14:32
4279,1999-04-26,Thomasville,Oklahoma,29634,1300,1300,0,8/31/2021 16:23,2/1/2022 11:35
4280,1981-09-08,Thomasville,Oregon,29634,950,950,0,8/31/2021 16:23,3/25/2022 17:54
4281,1958-11-04,Thomasville,Pennsylvania,29634,450,450,0,8/31/2021 16:25,1/17/2022 13:55
4282,2003-01-18,Thomasville,Rhode Island,29634,1130,1130,0,8/31/2021 16:26,5/3/2022 13:00
4283,2003-03-13,Thomasville,South Carolina,29634,660,660,0,8/31/2021 16:26,4/16/2022 12:36
4284,1968-10-02,Thomasville,South Dakota,29634,310,310,0,8/31/2021 16:27,4/29/2022 16:48
4285,1976-06-17,Thomasville,Tennessee,29634,600,600,0,8/31/2021 16:30,1/10/2022 9:56
4286,1984-06-08,Thomasville,Texas,29634,870,870,0,8/31/2021 16:34,5/4/2022 9:00
4287,1986-02-05,Thomasville,Utah,29634,400,400,0,8/31/2021 16:34,9/14/2021 18:31
4288,1966-11-03,Thomasville,Vermont,29634,300,300,0,8/31/2021 16:35,11/8/2021 9:08
4289,1997-01-26,Thomasville,Virginia,29634,1400,1400,0,8/31/2021 16:36,1/17/2022 9:02
4290,1970-02-01,Thomasville,Washington,29634,400,400,0,8/31/2021 16:36,1/31/2022 22:09
4291,1963-02-27,Thomasville,West Virginia,29634,350,350,0,8/31/2021 16:38,12/9/2021 10:52
4292,1961-03-07,Thomasville,Wisconsin,29634,950,950,0,8/31/2021 16:40,9/30/2021 17:13
4293,1989-08-23,Thomasville,Wyoming,29634,350,350,0,8/31/2021 16:41,9/17/2021 11:41
4294,1991-02-27,Thomasville,Alabama,29634,300,300,0,8/31/2021 16:41,2/5/2022 13:42
4295,1998-12-25,Thomasville,Alaska,29634,300,300,0,8/31/2021 16:43,11/27/2021 21:29
4296,1994-12-06,Thomasville,Arizona,29634,1430,1430,0,8/31/2021 16:47,5/10/2022 18:09
4297,1984-12-21,Thomasville,Arkansas,29634,310,310,0,8/31/2021 16:48,5/10/2022 18:27
4298,1990-01-08,Thomasville,California,29634,350,350,0,8/31/2021 17:00,10/16/2021 16:18
4299,1955-04-17,Thomasville,Colorado,29634,750,750,0,8/31/2021 17:06,1/22/2022 17:53
4300,1991-02-21,Thomasville,Connecticut,29634,610,610,0,8/31/2021 17:06,5/2/2022 18:02
4301,1963-11-25,Thomasville,Delaware,29634,850,850,0,8/31/2021 17:07,3/13/2022 22:39
4302,1992-04-18,Thomasville,District of Columbia,29634,1200,1200,0,8/31/2021 17:10,1/12/2022 19:22
4303,1953-04-10,Thomasville,Florida,29634,300,300,0,8/31/2021 17:18,2/25/2022 16:05
4304,1990-10-02,Thomasville,Georgia,29634,300,300,0,8/31/2021 17:18,3/2/2022 13:10
4305,2002-12-26,Thomasville,Hawaii,29634,450,450,0,8/31/2021 17:26,2/12/2022 14:30
4306,1999-05-18,Thomasville,Idaho,29634,1450,1450,0,8/31/2021 17:28,3/18/2022 21:06
4307,1997-03-05,Thomasville,Illinois,29634,770,770,0,8/31/2021 17:35,4/8/2022 19:05
4308,1995-12-16,Thomasville,Indiana,29634,600,600,0,8/31/2021 17:35,1/22/2022 0:44
4309,1954-05-06,Thomasville,Iowa,29634,2880,2880,0,8/31/2021 17:38,5/11/2022 18:11
4310,1981-11-25,Thomasville,Kansas,29634,300,300,0,8/31/2021 17:38,3/2/2022 21:02
4311,1999-05-28,Thomasville,Kentucky,29634,1610,1610,0,8/31/2021 17:58,4/19/2022 17:31
4312,1981-04-22,Thomasville,Louisiana,29634,300,300,0,8/31/2021 18:04,2/26/2022 19:20
4313,2004-11-20,Thomasville,Maine,29634,360,360,0,8/31/2021 18:11,6/25/2022 8:42
4314,2002-07-08,Thomasville,Maryland,29634,1950,1950,0,8/31/2021 18:16,3/16/2022 18:29
4315,1990-12-02,Thomasville,Massachusetts,29634,2080,2580,500,8/31/2021 18:17,5/6/2022 11:55
4316,1955-10-24,Thomasville,Michigan,29634,310,310,0,8/31/2021 18:18,4/8/2022 19:13
4317,1965-10-13,Thomasville,Minnesota,29634,350,350,0,8/31/2021 18:20,10/15/2021 10:03
4318,1977-05-19,Thomasville,Mississippi,29634,450,450,0,8/31/2021 18:21,3/13/2022 10:54
4319,1976-01-25,Thomasville,Missouri,29634,1860,1860,0,8/31/2021 18:25,6/30/2022 11:20
4320,1998-03-10,Thomasville,Montana,29634,600,1600,1000,8/31/2021 18:27,6/1/2022 14:55
4321,1960-04-12,Thomasville,Nebraska,29634,550,550,0,8/31/2021 18:31,3/2/2022 19:45
4322,1985-10-23,Thomasville,Nevada,29634,300,300,0,8/31/2021 18:32,1/22/2022 19:53
4323,1994-09-18,Thomasville,New Hampshire,29634,1020,1020,0,8/31/2021 18:36,4/11/2022 17:22
4324,1950-08-16,Thomasville,New Jersey,29634,1900,1900,0,8/31/2021 18:39,5/11/2022 18:26
4325,2002-12-29,Thomasville,New Mexico,29634,1480,1480,0,8/31/2021 18:49,6/30/2022 12:28
4326,2004-08-12,Thomasville,New York,29634,820,820,0,8/31/2021 18:50,6/26/2022 18:56
4327,1957-05-20,Thomasville,North Carolina,29634,670,1170,500,8/31/2021 18:51,4/9/2022 14:10
4328,1962-07-03,Thomasville,North Dakota,29634,450,450,0,8/31/2021 18:51,1/19/2022 19:14
4329,2000-04-10,Thomasville,Ohio,29634,550,1050,500,8/31/2021 18:58,3/2/2022 22:02
4330,1971-06-23,Thomasville,Oklahoma,29634,310,310,0,8/31/2021 19:00,6/3/2022 14:10
4331,1984-09-05,Thomasville,Oregon,29634,2760,3260,500,8/31/2021 19:01,4/19/2022 18:51
4332,2003-04-30,Mooresville,North Carolina,28117,2350,2350,0,8/31/2021 19:01,3/22/2022 9:56
4333,1980-08-20,Thomasville,Pennsylvania,29634,800,800,0,8/31/2021 19:02,5/3/2022 17:23
4334,1997-12-19,Thomasville,Rhode Island,29634,5960,5960,0,8/31/2021 19:03,6/4/2022 16:44
4335,1964-12-17,Thomasville,South Carolina,29634,220,1220,1000,8/31/2021 19:05,5/9/2022 18:00
4336,1986-03-03,Thomasville,South Dakota,29634,1180,1180,0,8/31/2021 19:14,6/30/2022 10:10
4337,1950-02-23,Thomasville,Tennessee,29634,700,700,0,8/31/2021 19:22,2/28/2022 23:49
4338,1999-05-13,Thomasville,Texas,29634,300,800,500,8/31/2021 19:24,1/21/2022 22:27
4339,1997-07-19,Thomasville,Utah,29634,650,650,0,8/31/2021 19:34,1/22/2022 20:05
4340,1953-05-21,Thomasville,Vermont,29634,300,300,0,8/31/2021 19:37,3/18/2022 16:03
4341,1998-02-17,Thomasville,Virginia,29634,1850,1850,0,8/31/2021 19:44,3/19/2022 17:01
4342,1977-01-03,Thomasville,Washington,29634,450,450,0,8/31/2021 19:51,1/19/2022 13:05
4343,1969-08-16,Thomasville,West Virginia,29634,3010,3010,0,8/31/2021 19:53,5/12/2022 13:11
4344,1985-12-31,Winston-Salem ,North Carolina,27106,450,450,0,8/31/2021 20:09,5/9/2022 22:48
4345,1987-12-19,Thomasville,Wisconsin,29634,350,350,0,8/31/2021 20:22,12/2/2021 15:00
4346,1990-09-22,Thomasville,Wyoming,29634,310,310,0,8/31/2021 20:28,5/2/2022 18:21
4347,1991-12-23,Thomasville,Alabama,29634,560,560,0,8/31/2021 20:29,6/30/2022 16:57
4348,2000-08-25,Thomasville,Alaska,29634,310,310,0,8/31/2021 20:34,4/10/2022 14:29
4349,1982-07-27,Thomasville,Arizona,29634,450,450,0,8/31/2021 20:48,11/17/2021 14:40
4350,1975-11-10,Thomasville,Arkansas,29634,300,300,0,8/31/2021 20:48,1/22/2022 13:20
4351,1958-03-17,Thomasville,California,29634,300,300,0,8/31/2021 20:48,1/22/2022 17:46
4352,1958-04-19,Thomasville,Colorado,29634,700,700,0,8/31/2021 20:54,3/20/2022 13:00
4353,1961-09-27,Thomasville,Connecticut,29634,320,320,0,8/31/2021 20:56,4/28/2022 13:14
4354,1999-05-10,Thomasville,Delaware,29634,650,650,0,8/31/2021 21:08,1/22/2022 18:53
4355,1971-07-13,Thomasville,District of Columbia,29634,800,800,0,8/31/2021 21:28,2/26/2022 20:46
4356,1990-04-27,Thomasville,Florida,29634,650,650,0,8/31/2021 21:33,3/23/2022 22:52
4357,2001-06-02,Thomasville,Georgia,29634,750,750,0,8/31/2021 21:38,1/22/2022 20:07
4358,1990-02-20,Thomasville,Hawaii,29634,1250,1750,500,8/31/2021 21:38,6/19/2022 14:37
4359,1978-05-07,Thomasville,Idaho,29634,5180,5180,0,8/31/2021 21:40,5/26/2022 20:48
4360,1974-05-23,Thomasville,Illinois,29634,350,350,0,8/31/2021 21:42,2/24/2022 0:02
4361,1996-07-07,Thomasville,Indiana,29634,1650,1650,0,8/31/2021 21:44,3/2/2022 21:08
4362,1972-04-15,Thomasville,Iowa,29634,300,300,0,8/31/2021 21:58,10/1/2021 9:48
4363,1952-10-05,Thomasville,Kansas,29634,300,300,0,8/31/2021 21:59,1/22/2022 19:41
4364,1987-04-07,Thomasville,Kentucky,29634,350,350,0,8/31/2021 22:01,1/22/2022 14:48
4365,2002-09-05,Thomasville,Louisiana,29634,2390,2390,0,8/31/2021 22:02,5/31/2022 11:46
4366,1972-07-01,Thomasville,Maine,29634,1850,1850,0,8/31/2021 22:08,2/28/2022 18:49
4367,1995-11-04,Thomasville,Maryland,29634,1500,2000,500,8/31/2021 22:14,3/15/2022 16:36
4368,1997-10-16,Thomasville,Massachusetts,29634,960,960,0,8/31/2021 22:15,4/15/2022 19:05
4369,1958-08-25,Thomasville,Michigan,29634,360,360,0,8/31/2021 22:25,5/25/2022 17:43
4370,1983-10-14,Thomasville,Minnesota,29634,300,300,0,8/31/2021 22:28,3/2/2022 21:10
4371,1999-08-29,Thomasville,Mississippi,29634,500,500,0,8/31/2021 22:33,1/21/2022 1:28
4372,2002-08-29,Thomasville,Missouri,29634,650,1150,500,8/31/2021 22:48,1/22/2022 19:19
4373,1993-01-23,Thomasville,Montana,29634,670,670,0,8/31/2021 22:51,4/15/2022 17:58
4374,1961-03-15,Thomasville,Nebraska,29634,630,630,0,8/31/2021 23:07,4/30/2022 19:49
4375,1975-07-10,Thomasville,Nevada,29634,600,600,0,8/31/2021 23:16,3/27/2022 1:05
4376,2005-02-02,Thomasville,New Hampshire,29634,4230,4230,0,8/31/2021 23:19,4/18/2022 12:24
4377,1981-12-09,Thomasville,New Jersey,29634,350,350,0,8/31/2021 23:45,9/28/2021 16:25
4378,1959-08-27,Thomasville,New Mexico,29634,500,500,0,9/1/2021 0:20,10/29/2021 20:27
4379,1954-04-02,Thomasville,New York,29634,710,710,0,9/1/2021 0:41,6/6/2022 14:59
4380,1970-05-01,Thomasville,North Carolina,29634,460,460,0,9/1/2021 0:51,5/17/2022 15:41
4381,2000-12-10,Thomasville,North Dakota,29634,320,320,0,9/1/2021 1:07,6/16/2022 23:00
4382,2001-12-01,Thomasville,Ohio,29634,400,400,0,9/1/2021 1:07,4/3/2022 11:09
4383,1969-02-10,Thomasville,Oklahoma,29634,620,620,0,9/1/2021 5:34,5/11/2022 14:58
4384,1996-06-20,Thomasville,Oregon,29634,1410,1410,0,9/1/2021 7:36,6/20/2022 7:47
4385,1995-11-13,Thomasville,Pennsylvania,29634,850,850,0,9/1/2021 7:52,3/14/2022 16:51
4386,2000-12-22,Thomasville,Rhode Island,29634,1010,1010,0,9/1/2021 7:53,12/23/2021 18:34
4387,1967-12-24,Thomasville,South Carolina,29634,1750,1750,0,9/1/2021 8:03,3/2/2022 20:54
4388,1956-03-11,Thomasville,South Dakota,29634,360,860,500,9/1/2021 8:45,5/14/2022 13:53
4389,1987-02-01,Thomasville,Tennessee,29634,660,660,0,9/1/2021 9:06,3/26/2022 13:37
4390,1960-09-25,Thomasville,Texas,29634,320,320,0,9/1/2021 9:09,5/13/2022 18:35
4391,1986-08-26,Thomasville,Utah,29634,1000,1000,0,9/1/2021 9:16,11/13/2021 22:56
4392,2002-07-31,Thomasville,Vermont,29634,510,510,0,9/1/2021 9:21,4/11/2022 23:55
4393,1954-12-26,Thomasville,Virginia,29634,360,360,0,9/1/2021 9:26,5/14/2022 10:23
4394,1950-06-06,Thomasville,Washington,29634,1410,1410,0,9/1/2021 9:28,6/26/2022 13:47
4395,1984-02-18,Thomasville,West Virginia,29634,650,650,0,9/1/2021 9:34,3/26/2022 16:12
4396,1955-04-23,Thomasville,Wisconsin,29634,300,300,0,9/1/2021 9:35,3/5/2022 16:08
4397,1964-06-27,Thomasville,Wyoming,29634,700,700,0,9/1/2021 9:42,10/15/2021 16:42
4398,1998-12-03,Thomasville,Alabama,29634,1050,1050,0,9/1/2021 9:42,3/2/2022 9:16
4399,2004-05-21,Thomasville,Alaska,29634,300,300,0,9/1/2021 9:55,2/11/2022 13:05
4400,1990-12-17,Thomasville,Arizona,29634,1000,1500,500,9/1/2021 10:10,6/14/2022 18:57
4401,1998-07-14,Thomasville,Arkansas,29634,300,300,0,9/1/2021 10:13,1/22/2022 5:36
4402,1989-01-18,Thomasville,California,29634,600,600,0,9/1/2021 10:21,11/27/2021 21:22
4403,2001-02-01,Thomasville,Colorado,29634,300,300,0,9/1/2021 10:33,11/13/2021 18:52
4404,1961-05-15,Thomasville,Connecticut,29634,2070,2070,0,9/1/2021 10:39,5/4/2022 9:00
4405,1962-11-09,Thomasville,Delaware,29634,300,300,0,9/1/2021 10:44,1/7/2022 15:24
4406,1960-06-12,Thomasville,District of Columbia,29634,310,310,0,9/1/2021 10:45,3/29/2022 16:07
4407,1976-02-27,Thomasville,Florida,29634,300,300,0,9/1/2021 10:46,11/30/2021 11:49
4408,2003-01-08,Thomasville,Georgia,29634,2920,2920,0,9/1/2021 10:55,4/16/2022 15:46
4409,2000-06-28,Thomasville,Hawaii,29634,100,100,0,9/1/2021 10:57,9/1/2021 11:10
4410,1992-03-16,Thomasville,Idaho,29634,580,580,0,9/1/2021 10:57,4/10/2022 9:43
4411,1988-01-25,Thomasville,Illinois,29634,1220,1220,0,9/1/2021 11:01,1/22/2022 19:25
4412,1965-08-24,Thomasville,Indiana,29634,350,350,0,9/1/2021 11:08,1/22/2022 18:36
4413,1999-05-19,Thomasville,Iowa,29634,910,910,0,9/1/2021 11:08,6/7/2022 20:20
4414,1958-07-11,Thomasville,Kansas,29634,1830,3830,2000,9/1/2021 11:10,6/5/2022 15:42
4415,1989-06-16,Thomasville,Kentucky,29634,2215,2215,0,9/1/2021 11:15,5/11/2022 3:06
4416,1989-11-18,Thomasville,Louisiana,29634,300,300,0,9/1/2021 11:17,11/10/2021 22:55
4417,1982-08-25,Thomasville,Maine,29634,300,300,0,9/1/2021 11:28,11/20/2021 14:14
4418,1992-04-07,Thomasville,Maryland,29634,800,800,0,9/1/2021 11:29,2/15/2022 19:58
4419,2003-04-24,Thomasville,Massachusetts,29634,1350,1850,500,9/1/2021 11:33,3/2/2022 11:29
4420,1973-06-19,Thomasville,Michigan,29634,300,300,0,9/1/2021 11:47,1/22/2022 18:51
4421,1981-01-22,Thomasville,Minnesota,29634,1320,1320,0,9/1/2021 11:57,4/12/2022 16:36
4422,1991-02-23,Thomasville,Mississippi,29634,2440,2440,0,9/1/2021 12:00,4/17/2022 12:46
4423,2003-05-08,Thomasville,Missouri,29634,2500,2500,0,9/1/2021 12:04,4/18/2022 11:19
4424,1958-02-25,Thomasville,Montana,29634,450,450,0,9/1/2021 12:08,1/22/2022 13:44
4425,1983-01-19,Thomasville,Nebraska,29634,310,310,0,9/1/2021 12:08,4/7/2022 18:01
4426,1998-09-15,Thomasville,Nevada,29634,360,360,0,9/1/2021 12:13,5/21/2022 21:07
4427,1975-04-20,Thomasville,New Hampshire,29634,450,450,0,9/1/2021 12:23,10/13/2021 11:00
4428,2000-02-03,Thomasville,New Jersey,29634,450,450,0,9/1/2021 12:25,9/13/2021 23:48
4429,1959-05-26,Thomasville,New Mexico,29634,820,820,0,9/1/2021 12:33,5/10/2022 18:03
4430,1983-11-14,Thomasville,New York,29634,650,650,0,9/1/2021 12:40,2/25/2022 17:40
4431,1978-07-23,Thomasville,North Carolina,29634,780,1780,1000,9/1/2021 12:40,5/14/2022 10:51
4432,1963-08-06,Thomasville,North Dakota,29634,2730,2730,0,9/1/2021 12:42,4/19/2022 18:52
4433,1994-01-06,Thomasville,Ohio,29634,310,310,0,9/1/2021 12:43,4/13/2022 15:29
4434,1955-09-22,Thomasville,Oklahoma,29634,350,350,0,9/1/2021 12:48,3/20/2022 15:13
4435,1980-11-25,Thomasville,Oregon,29634,370,370,0,9/1/2021 12:58,6/24/2022 1:48
4436,1979-04-10,Thomasville,Pennsylvania,29634,450,450,0,9/1/2021 12:59,11/13/2021 15:18
4437,1957-01-27,Thomasville,Rhode Island,29634,400,400,0,9/1/2021 13:26,12/3/2021 8:23
4438,1964-08-22,Thomasville,South Carolina,29634,1250,1250,0,9/1/2021 13:42,3/26/2022 17:00
4439,1982-03-02,Thomasville,South Dakota,29634,1020,1020,0,9/1/2021 13:51,4/30/2022 18:30
4440,1983-09-06,Thomasville,Tennessee,29634,460,460,0,9/1/2021 13:57,4/29/2022 21:10
4441,1974-11-23,Thomasville,Texas,29634,650,650,0,9/1/2021 13:57,11/13/2021 18:15
4442,1990-01-28,Thomasville,Utah,29634,320,320,0,9/1/2021 14:03,5/11/2022 18:10
4443,1980-05-21,Thomasville,Vermont,29634,300,300,0,9/1/2021 14:06,2/16/2022 11:52
4444,1956-04-16,Thomasville,Virginia,29634,900,900,0,9/1/2021 14:08,3/2/2022 22:59
4445,1997-01-22,Thomasville,Washington,29634,1150,1150,0,9/1/2021 14:18,3/2/2022 21:18
4446,1994-06-20,Thomasville,West Virginia,29634,500,500,0,9/1/2021 14:19,1/12/2022 16:50
4447,1977-03-01,Thomasville,Wisconsin,29634,300,300,0,9/1/2021 14:23,11/29/2021 17:12
4448,1991-08-19,Thomasville,Wyoming,29634,3040,3040,0,9/1/2021 14:34,4/18/2022 17:39
4449,1983-05-13,Thomasville,Alabama,29634,300,300,0,9/1/2021 14:38,9/7/2021 11:00
4450,1984-03-08,Thomasville,Alaska,29634,1650,1650,0,9/1/2021 15:03,5/2/2022 19:34
4451,1980-11-21,Thomasville,Arizona,29634,200,700,500,9/1/2021 15:21,4/6/2022 17:30
4452,1995-06-19,Winston-Salem,North Carolina,27101,400,400,0,9/1/2021 15:27,2/19/2022 13:00
4453,1969-03-14,Thomasville,Arkansas,29634,400,400,0,9/1/2021 15:33,2/28/2022 18:17
4454,1964-11-07,Thomasville,California,29634,1420,1420,0,9/1/2021 15:48,3/6/2022 1:22
4455,1985-10-19,Thomasville,Colorado,29634,950,950,0,9/1/2021 16:00,3/2/2022 20:13
4456,1986-06-04,Thomasville,Connecticut,29634,560,560,0,9/1/2021 16:06,10/11/2021 8:36
4457,2003-01-02,Thomasville,Delaware,29634,850,850,0,9/1/2021 16:35,3/16/2022 9:47
4458,2001-10-08,Thomasville,District of Columbia,29634,1100,1100,0,9/1/2021 16:44,3/18/2022 16:17
4459,2003-06-20,Thomasville,Florida,29634,300,300,0,9/1/2021 16:45,1/20/2022 12:58
4460,1987-12-18,Thomasville,Georgia,29634,550,550,0,9/1/2021 16:47,10/21/2021 19:03
4461,1976-11-16,Thomasville,Hawaii,29634,1550,1550,0,9/1/2021 17:15,3/2/2022 22:44
4462,1958-09-25,Thomasville,Idaho,29634,1630,1630,0,9/1/2021 17:16,5/2/2022 18:01
4463,1961-11-12,Thomasville,Illinois,29634,560,560,0,9/1/2021 17:41,4/8/2022 18:58
4464,1958-02-03,Thomasville,Indiana,29634,450,450,0,9/1/2021 17:43,12/24/2021 20:28
4465,1972-11-01,Thomasville,Iowa,29634,300,300,0,9/1/2021 17:47,10/30/2021 15:17
4466,1955-04-04,Thomasville,Kansas,29634,1400,1400,0,9/1/2021 18:01,2/18/2022 18:12
4467,1995-04-09,Thomasville,Kentucky,29634,300,300,0,9/1/2021 18:03,9/11/2021 21:17
4468,1997-02-24,Thomasville,Louisiana,29634,400,400,0,9/1/2021 18:04,1/12/2022 17:01
4469,1996-09-30,Thomasville,Maine,29634,1410,1410,0,9/1/2021 18:09,5/11/2022 18:13
4470,1993-10-27,Thomasville,Maryland,29634,600,600,0,9/1/2021 18:13,3/30/2022 18:02
4471,2000-01-30,Thomasville,Massachusetts,29634,1410,1410,0,9/1/2021 18:27,4/19/2022 17:52
4472,1973-07-08,Thomasville,Michigan,29634,810,810,0,9/1/2021 18:32,4/13/2022 9:00
4473,2021-09-25,Thomasville,Minnesota,29634,2420,2420,0,9/1/2021 18:51,4/30/2022 8:58
4474,2003-04-30,Thomasville,Mississippi,29634,5680,5680,0,9/1/2021 18:52,4/7/2022 10:53
4475,1999-09-07,Thomasville,Missouri,29634,450,450,0,9/1/2021 18:57,9/9/2021 19:38
4476,1980-03-25,Thomasville,Montana,29634,750,750,0,9/1/2021 19:05,1/29/2022 11:02
4477,1971-11-22,Thomasville,Nebraska,29634,410,410,0,9/1/2021 19:16,4/30/2022 0:07
4478,1957-12-11,Thomasville,Nevada,29634,350,350,0,9/1/2021 19:27,12/4/2021 14:14
4479,1998-12-09,Thomasville,New Hampshire,29634,2770,2770,0,9/1/2021 19:33,3/19/2022 16:09
4480,1951-04-15,Thomasville,New Jersey,29634,460,460,0,9/1/2021 19:58,4/9/2022 14:26
4481,2003-04-01,Thomasville,New Mexico,29634,2495,2495,0,9/1/2021 19:58,4/8/2022 12:46
4482,2003-11-24,Thomasville,New York,29634,300,300,0,9/1/2021 20:14,2/8/2022 21:23
4483,1999-03-24,Thomasville,North Carolina,29634,1560,1560,0,9/1/2021 20:19,4/30/2022 9:01
4484,1994-04-25,Thomasville,North Dakota,29634,1570,1570,0,9/1/2021 20:22,5/4/2022 11:13
4485,1969-05-08,Thomasville,Ohio,29634,1100,1100,0,9/1/2021 20:23,3/31/2022 12:30
4486,1987-02-18,Thomasville,Oklahoma,29634,700,700,0,9/1/2021 20:24,3/30/2022 12:12
4487,1953-03-09,Thomasville,Oregon,29634,870,870,0,9/1/2021 20:28,5/11/2022 17:25
4488,1982-08-15,Thomasville,Pennsylvania,29634,0,500,500,9/1/2021 20:28,4/3/2022 21:06
4489,1986-05-21,Thomasville,Rhode Island,29634,1170,1170,0,9/1/2021 20:30,5/11/2022 17:24
4490,2002-12-20,Thomasville,South Carolina,29634,6690,6690,0,9/1/2021 20:34,5/7/2022 4:14
4491,2004-01-06,Thomasville,South Dakota,29634,760,760,0,9/1/2021 20:38,5/21/2022 10:52
4492,1964-01-12,Thomasville,Tennessee,29634,330,330,0,9/1/2021 20:41,5/10/2022 21:06
4493,1979-10-08,Thomasville,Texas,29634,300,300,0,9/1/2021 21:13,1/22/2022 20:41
4494,1962-10-13,Thomasville,Utah,29634,560,560,0,9/1/2021 21:13,5/3/2022 13:03
4495,1998-06-17,Thomasville,Vermont,29634,400,400,0,9/1/2021 21:20,10/25/2021 7:42
4496,1996-11-04,Thomasville,Virginia,29634,490,490,0,9/1/2021 21:23,5/8/2022 13:13
4497,1968-04-17,Thomasville,Washington,29634,1060,1060,0,9/1/2021 21:23,5/11/2022 13:01
4498,1951-01-01,Thomasville,West Virginia,29634,450,450,0,9/1/2021 21:25,9/3/2021 20:17
4499,2003-07-17,Thomasville,Wisconsin,29634,760,760,0,9/1/2021 21:31,4/6/2022 9:00
4500,1972-12-28,Thomasville,Wyoming,29634,560,560,0,9/1/2021 21:31,9/26/2021 19:02
4501,1987-04-16,Thomasville,Alabama,29634,350,350,0,9/1/2021 21:34,1/10/2022 10:43
4502,1956-01-11,Thomasville,Alaska,29634,1710,1710,0,9/1/2021 21:47,4/18/2022 10:57
4503,1965-01-14,Thomasville,Arizona,29634,1980,1980,0,9/1/2021 21:52,6/23/2022 17:16
4504,1968-06-09,Thomasville,Arkansas,29634,700,700,0,9/1/2021 21:54,3/26/2022 15:38
4505,2000-04-25,Thomasville,California,29634,400,400,0,9/1/2021 21:59,2/19/2022 11:19
4506,1997-07-09,Thomasville,Colorado,29634,370,370,0,9/1/2021 22:11,5/27/2022 23:08
4507,1970-06-22,Thomasville,Connecticut,29634,750,750,0,9/1/2021 22:15,1/22/2022 18:49
4508,1978-02-06,Thomasville,Delaware,29634,3060,3060,0,9/1/2021 22:23,5/13/2022 14:48
4509,1967-04-17,Thomasville,District of Columbia,29634,340,340,0,9/1/2021 22:24,5/11/2022 16:28
4510,1972-01-17,Thomasville,Florida,29634,300,300,0,9/1/2021 22:30,1/12/2022 19:21
4511,2001-07-26,Thomasville,Georgia,29634,350,350,0,9/1/2021 22:46,3/26/2022 10:36
4512,1998-01-14,Thomasville,Hawaii,29634,1420,1420,0,9/1/2021 22:50,4/25/2022 18:08
4513,1995-07-26,Thomasville,Idaho,29634,610,610,0,9/1/2021 22:54,5/9/2022 21:48
4514,1993-03-02,Thomasville,Illinois,29634,320,320,0,9/1/2021 22:54,5/11/2022 13:10
4515,1992-02-10,Thomasville,Indiana,29634,2420,2420,0,9/1/2021 22:55,5/6/2022 15:54
4516,1980-11-19,Thomasville,Iowa,29634,1050,1050,0,9/1/2021 22:55,3/2/2022 20:51
4517,1985-07-21,Thomasville,Kansas,29634,2420,2420,0,9/1/2021 22:56,6/21/2022 11:32
4518,1999-09-17,Thomasville,Kentucky,29634,400,400,0,9/1/2021 22:56,3/7/2022 18:07
4519,1998-09-19,Thomasville,Louisiana,29634,1600,1600,0,9/1/2021 22:58,2/26/2022 18:48
4520,1998-09-26,Thomasville,Maine,29634,1530,1530,0,9/1/2021 23:12,5/17/2022 14:51
4521,1958-06-03,Thomasville,Maryland,29634,660,660,0,9/1/2021 23:21,5/5/2022 10:54
4522,1953-12-05,Thomasville,Massachusetts,29634,610,610,0,9/1/2021 23:22,4/12/2022 23:46
4523,2001-02-20,Thomasville,Michigan,29634,1690,2190,500,9/1/2021 23:35,5/20/2022 17:31
4524,1966-01-03,Thomasville,Minnesota,29634,450,450,0,9/2/2021 0:06,3/23/2022 19:19
4525,1979-09-16,Thomasville,Mississippi,29634,650,650,0,9/2/2021 0:58,2/22/2022 10:17
4526,1957-10-09,Thomasville,Missouri,29634,320,320,0,9/2/2021 7:36,5/11/2022 18:14
4527,1976-04-02,Thomasville,Montana,29634,350,350,0,9/2/2021 7:45,3/7/2022 18:34
4528,1969-02-05,Thomasville,Nebraska,29634,450,450,0,9/2/2021 7:46,1/23/2022 15:18
4529,1980-05-26,Thomasville,Nevada,29634,900,900,0,9/2/2021 8:03,3/26/2022 16:17
4530,1959-04-21,Thomasville,New Hampshire,29634,300,300,0,9/2/2021 8:11,1/19/2022 23:13
4531,1986-04-19,Thomasville,New Jersey,29634,300,300,0,9/2/2021 8:57,1/12/2022 17:56
4532,2005-08-03,Thomasville,New Mexico,29634,300,300,0,9/2/2021 9:04,1/10/2022 21:10
4533,2001-02-10,Thomasville,New York,29634,300,300,0,9/2/2021 9:06,11/27/2021 19:28
4534,1966-01-04,Thomasville,North Carolina,29634,400,400,0,9/2/2021 9:09,3/1/2022 12:08
4535,1968-06-06,Thomasville,North Dakota,29634,500,500,0,9/2/2021 9:10,1/10/2022 21:10
4536,1975-08-06,Thomasville,Ohio,29634,460,460,0,9/2/2021 9:13,1/10/2022 13:04
4537,2000-07-09,Thomasville,Oklahoma,29634,3100,3100,0,9/2/2021 9:30,4/10/2022 10:58
4538,1988-10-09,Thomasville,Oregon,29634,900,900,0,9/2/2021 9:31,3/16/2022 20:12
4539,1973-07-12,Thomasville,Pennsylvania,29634,300,300,0,9/2/2021 9:42,1/22/2022 18:48
4540,2001-04-07,Thomasville,Rhode Island,29634,1250,1250,0,9/2/2021 9:48,3/26/2022 16:16
4541,1980-07-26,Thomasville,South Carolina,29634,310,310,0,9/2/2021 9:49,2/2/2022 19:13
4542,1955-11-01,Thomasville,South Dakota,29634,610,610,0,9/2/2021 9:53,4/8/2022 23:33
4543,1996-08-10,Thomasville,Tennessee,29634,2980,2980,0,9/2/2021 10:07,6/19/2022 2:37
4544,1961-10-23,Thomasville,Texas,29634,360,360,0,9/2/2021 10:23,4/9/2022 13:51
4545,1996-02-12,Thomasville,Utah,29634,1320,1320,0,9/2/2021 10:33,5/13/2022 21:44
4546,1962-04-25,Thomasville,Vermont,29634,420,420,0,9/2/2021 10:35,4/18/2022 19:40
4547,1969-08-13,Thomasville,Virginia,29634,350,350,0,9/2/2021 10:38,1/19/2022 10:13
4548,1991-10-05,Winston-Salem ,North Carolina,27106,1360,1860,500,9/2/2021 10:46,3/14/2022 10:42
4549,1971-11-15,Thomasville,Washington,29634,1430,1430,0,9/2/2021 10:55,4/30/2022 8:58
4550,1961-06-15,Thomasville,West Virginia,29634,300,300,0,9/2/2021 10:59,1/19/2022 19:47
4551,1977-05-26,Thomasville,Wisconsin,29634,1550,1550,0,9/2/2021 10:59,3/19/2022 17:48
4552,1998-02-27,Thomasville,Wyoming,29634,760,760,0,9/2/2021 11:01,4/9/2022 16:05
4553,1957-12-03,Thomasville,Alabama,29634,300,300,0,9/2/2021 11:04,11/5/2021 17:18
4554,1996-01-26,Thomasville,Alaska,29634,2070,2070,0,9/2/2021 11:05,6/18/2022 9:41
4555,1967-12-05,Thomasville,Arizona,29634,360,360,0,9/2/2021 11:06,4/15/2022 14:00
4556,1960-01-15,Thomasville,Arkansas,29634,1300,1300,0,9/2/2021 11:14,2/26/2022 18:24
4557,1956-06-27,Thomasville,California,29634,2070,2070,0,9/2/2021 11:21,4/10/2022 13:35
4558,2004-03-22,Thomasville,Colorado,29634,850,850,0,9/2/2021 11:29,2/18/2022 18:00
4559,1975-10-26,Thomasville,Connecticut,29634,50,550,500,9/2/2021 11:29,12/1/2021 14:39
4560,1969-05-26,Thomasville,Delaware,29634,400,400,0,9/2/2021 11:41,2/18/2022 20:21
4561,2001-10-13,Thomasville,District of Columbia,29634,400,400,0,9/2/2021 11:42,2/11/2022 13:03
4562,1970-06-06,Thomasville,Florida,29634,1060,1060,0,9/2/2021 11:47,3/25/2022 16:52
4563,1999-01-12,Winston-Salem,North Carolina,27106,450,450,0,9/2/2021 11:52,1/22/2022 16:07
4564,1999-04-01,Thomasville,Georgia,29634,300,300,0,9/2/2021 12:00,11/14/2021 8:07
4565,1982-12-25,Thomasville,Hawaii,29634,400,400,0,9/2/2021 12:08,3/11/2022 10:41
4566,1968-08-17,Thomasville,Idaho,29634,1830,1830,0,9/2/2021 12:10,5/11/2022 19:09
4567,1967-02-03,Thomasville,Illinois,29634,50,550,500,9/2/2021 12:12,2/5/2022 22:34
4568,1961-02-15,Thomasville,Indiana,29634,550,550,0,9/2/2021 12:13,5/19/2022 18:50
4569,1982-02-23,Thomasville,Iowa,29634,400,400,0,9/2/2021 12:16,1/22/2022 20:02
4570,1989-03-28,Thomasville,Kansas,29634,300,300,0,9/2/2021 12:21,2/9/2022 13:50
4571,1950-10-25,Thomasville,Kentucky,29634,660,660,0,9/2/2021 12:23,4/19/2022 12:31
4572,1970-04-06,Thomasville,Louisiana,29634,350,350,0,9/2/2021 12:28,1/19/2022 13:01
4573,1972-10-19,Thomasville,Maine,29634,680,1180,500,9/2/2021 12:28,4/16/2022 17:14
4574,1970-10-17,Thomasville,Maryland,29634,200,700,500,9/2/2021 12:29,2/28/2022 9:00
4575,1982-02-16,Thomasville,Massachusetts,29634,300,300,0,9/2/2021 12:33,2/12/2022 14:32
4576,1971-02-01,Thomasville,Michigan,29634,300,300,0,9/2/2021 12:38,2/2/2022 17:22
4577,1964-09-10,Thomasville,Minnesota,29634,1350,1350,0,9/2/2021 12:41,2/19/2022 15:03
4578,1984-11-13,Thomasville,Mississippi,29634,300,300,0,9/2/2021 12:49,3/10/2022 5:46
4579,1970-02-22,Thomasville,Missouri,29634,700,700,0,9/2/2021 12:51,2/12/2022 14:53
4580,1971-09-28,Thomasville,Montana,29634,1030,1030,0,9/2/2021 12:57,6/18/2022 2:43
4581,1988-07-17,Thomasville,Nebraska,29634,350,350,0,9/2/2021 12:57,1/12/2022 18:21
4582,1978-02-04,Thomasville,Nevada,29634,450,450,0,9/2/2021 12:57,1/22/2022 2:04
4583,1995-11-10,Thomasville,New Hampshire,29634,1450,1450,0,9/2/2021 12:58,3/13/2022 22:43
4584,1976-11-06,Thomasville,New Jersey,29634,950,950,0,9/2/2021 13:01,3/17/2022 20:57
4585,2001-03-13,Thomasville,New Mexico,29634,1400,1400,0,9/2/2021 13:23,1/22/2022 21:40
4586,1956-03-25,Thomasville,New York,29634,1100,1100,0,9/2/2021 13:23,3/5/2022 16:38
4587,1974-01-25,Thomasville,North Carolina,29634,1390,2390,1000,9/2/2021 13:25,5/11/2022 18:17
4588,2003-01-17,Thomasville,North Dakota,29634,450,450,0,9/2/2021 13:39,1/30/2022 10:33
4589,2001-09-11,Thomasville,Ohio,29634,400,400,0,9/2/2021 13:47,1/21/2022 23:49
4590,2003-02-21,Thomasville,Oklahoma,29634,300,300,0,9/2/2021 13:47,10/30/2021 16:11
4591,1973-10-03,Thomasville,Oregon,29634,1550,1550,0,9/2/2021 13:48,5/7/2022 11:51
4592,1976-06-07,Thomasville,Pennsylvania,29634,360,360,0,9/2/2021 13:49,4/21/2022 14:18
4593,2004-11-15,Thomasville,Rhode Island,29634,660,660,0,9/2/2021 13:50,6/11/2022 23:46
4594,1974-10-20,Thomasville,South Carolina,29634,350,350,0,9/2/2021 13:51,10/30/2021 15:59
4595,2000-07-20,Thomasville,South Dakota,29634,3230,3230,0,9/2/2021 13:52,6/30/2022 22:08
4596,2004-07-19,Thomasville,Tennessee,29634,300,300,0,9/2/2021 13:54,3/10/2022 15:34
4597,2002-02-13,Thomasville,Texas,29634,300,300,0,9/2/2021 13:58,3/14/2022 22:39
4598,1954-04-16,Thomasville,Utah,29634,300,300,0,9/2/2021 13:58,3/31/2022 16:15
4599,2000-05-19,Thomasville,Vermont,29634,1250,1250,0,9/2/2021 14:02,3/20/2022 20:37
4600,1988-03-03,Thomasville,Virginia,29634,510,510,0,9/2/2021 14:09,5/3/2022 19:16
4601,1998-10-01,Thomasville,Washington,29634,810,810,0,9/2/2021 14:13,1/25/2022 20:57
4602,1958-08-20,Thomasville,West Virginia,29634,350,350,0,9/2/2021 14:17,9/3/2021 19:36
4603,1974-01-24,Thomasville,Wisconsin,29634,1510,1510,0,9/2/2021 14:40,3/19/2022 12:48
4604,1957-05-02,Thomasville,Wyoming,29634,1010,1010,0,9/2/2021 14:46,4/16/2022 13:41
4605,1977-02-05,Thomasville,Alabama,29634,350,350,0,9/2/2021 15:00,1/12/2022 16:26
4606,1969-08-24,Thomasville,Alaska,29634,300,300,0,9/2/2021 15:01,9/10/2021 20:28
4607,1970-12-24,Thomasville,Arizona,29634,350,350,0,9/2/2021 15:07,3/8/2022 15:13
4608,1973-04-27,Thomasville,Arkansas,29634,2250,2250,0,9/2/2021 15:10,2/12/2022 15:11
4609,2005-06-10,Thomasville,California,29634,750,750,0,9/2/2021 15:18,2/4/2022 15:48
4610,1962-10-26,Thomasville,Colorado,29634,1280,1280,0,9/2/2021 15:20,5/11/2022 1:42
4611,2003-10-04,Thomasville,Connecticut,29634,400,400,0,9/2/2021 15:20,2/24/2022 19:42
4612,1982-05-09,Thomasville,Delaware,29634,300,300,0,9/2/2021 15:22,12/14/2021 18:56
4613,1956-03-28,Thomasville,District of Columbia,29634,570,570,0,9/2/2021 15:22,4/19/2022 19:09
4614,1968-01-28,Thomasville,Florida,29634,650,650,0,9/2/2021 15:23,2/19/2022 14:02
4615,1965-06-03,Thomasville,Georgia,29634,340,340,0,9/2/2021 15:24,4/19/2022 16:25
4616,1954-09-13,Thomasville,Hawaii,29634,1550,1550,0,9/2/2021 15:25,1/12/2022 12:17
4617,1985-10-03,Thomasville,Idaho,29634,0,500,500,9/2/2021 15:30,3/30/2022 11:00
4618,1993-11-10,Thomasville,Illinois,29634,300,300,0,9/2/2021 15:33,3/16/2022 19:02
4619,1985-01-18,Thomasville,Indiana,29634,400,400,0,9/2/2021 15:39,11/23/2021 13:21
4620,2001-11-09,Thomasville,Iowa,29634,2265,2265,0,9/2/2021 15:41,6/22/2022 23:32
4621,1972-03-05,Thomasville,Kansas,29634,1150,1150,0,9/2/2021 15:44,1/11/2022 20:55
4622,1950-09-18,Thomasville,Kentucky,29634,1770,1770,0,9/2/2021 15:46,5/3/2022 19:34
4623,1999-03-13,Thomasville,Louisiana,29634,350,350,0,9/2/2021 15:49,11/12/2021 0:49
4624,1989-02-04,Thomasville,Maine,29634,300,300,0,9/2/2021 15:51,3/2/2022 16:32
4625,1998-01-18,Thomasville,Maryland,29634,270,770,500,9/2/2021 15:59,11/30/2021 18:31
4626,1981-11-17,Thomasville,Massachusetts,29634,350,350,0,9/2/2021 16:06,11/12/2021 23:53
4627,1971-06-11,Thomasville,Michigan,29634,800,800,0,9/2/2021 16:11,2/3/2022 19:21
4628,1994-04-16,Thomasville,Minnesota,29634,400,400,0,9/2/2021 16:12,9/3/2021 19:36
4629,2003-05-07,Thomasville,Mississippi,29634,410,410,0,9/2/2021 16:14,4/21/2022 17:20
4630,1963-05-19,Thomasville,Missouri,29634,1160,1160,0,9/2/2021 16:16,4/16/2022 11:53
4631,2001-12-09,Thomasville,Montana,29634,760,760,0,9/2/2021 16:16,4/17/2022 1:17
4632,1982-09-02,Thomasville,Nebraska,29634,860,860,0,9/2/2021 16:36,5/3/2022 17:35
4633,1976-09-14,Thomasville,Nevada,29634,350,350,0,9/2/2021 16:37,1/12/2022 18:00
4634,1998-04-16,Winston-Salem,North Carolina,27106,1060,1560,500,9/2/2021 16:42,3/18/2022 17:24
4635,1998-01-20,Thomasville,New Hampshire,29634,750,750,0,9/2/2021 16:43,1/22/2022 19:17
4636,1983-12-20,Thomasville,New Jersey,29634,2380,4380,2000,9/2/2021 16:46,6/7/2022 13:29
4637,2000-06-15,Thomasville,New Mexico,29634,450,450,0,9/2/2021 16:48,3/19/2022 16:56
4638,1996-05-25,Thomasville,New York,29634,630,630,0,9/2/2021 16:51,5/11/2022 18:10
4639,1965-03-09,Thomasville,North Carolina,29634,300,300,0,9/2/2021 16:51,2/24/2022 21:28
4640,1978-03-20,Thomasville,North Dakota,29634,1200,1200,0,9/2/2021 17:03,1/23/2022 9:53
4641,2005-02-23,Thomasville,Ohio,29634,1060,1060,0,9/2/2021 17:09,5/3/2022 17:52
4642,1964-10-18,Thomasville,Oklahoma,29634,1110,1610,500,9/2/2021 17:10,5/3/2022 17:54
4643,1984-11-14,Thomasville,Oregon,29634,600,600,0,9/2/2021 17:11,2/20/2022 16:00
4644,1968-01-12,Thomasville,Pennsylvania,29634,300,300,0,9/2/2021 17:14,2/12/2022 15:02
4645,1990-12-11,Thomasville,Rhode Island,29634,1620,1620,0,9/2/2021 17:17,4/30/2022 10:06
4646,1977-05-09,Thomasville,South Carolina,29634,300,300,0,9/2/2021 17:19,3/12/2022 10:44
4647,1963-08-05,Thomasville,South Dakota,29634,2010,2010,0,9/2/2021 17:21,2/26/2022 19:31
4648,1983-12-15,Thomasville,Tennessee,29634,310,310,0,9/2/2021 17:24,4/29/2022 20:13
4649,1966-09-23,Thomasville,Texas,29634,1560,1560,0,9/2/2021 17:27,5/7/2022 10:42
4650,1978-04-11,Thomasville,Utah,29634,300,300,0,9/2/2021 17:31,9/2/2021 18:03
4651,1974-01-02,Thomasville,Vermont,29634,3740,3740,0,9/2/2021 17:35,5/14/2022 19:10
4652,1994-05-11,Thomasville,Virginia,29634,300,300,0,9/2/2021 17:35,11/13/2021 15:41
4653,2000-11-04,Thomasville,Washington,29634,400,400,0,9/2/2021 17:37,11/30/2021 11:49
4654,1994-12-03,Thomasville,West Virginia,29634,2045,26045,24000,9/2/2021 17:43,6/30/2022 17:02
4655,1993-06-13,Thomasville,Wisconsin,29634,220,720,500,9/2/2021 17:53,4/8/2022 18:21
4656,1972-01-11,Thomasville,Wyoming,29634,300,300,0,9/2/2021 17:56,11/13/2021 20:53
4657,1981-02-11,Thomasville,Alabama,29634,3450,3450,0,9/2/2021 17:56,3/15/2022 22:14
4658,1986-10-10,Thomasville,Alaska,29634,470,470,0,9/2/2021 17:58,5/3/2022 17:46
4659,1982-05-23,Thomasville,Arizona,29634,340,340,0,9/2/2021 18:03,5/25/2022 23:15
4660,1963-01-23,Thomasville,Arkansas,29634,900,900,0,9/2/2021 18:05,3/8/2022 10:26
4661,1950-05-19,Thomasville,California,29634,850,850,0,9/2/2021 18:05,1/12/2022 17:41
4662,1977-09-11,Thomasville,Colorado,29634,650,650,0,9/2/2021 18:09,2/13/2022 17:08
4663,2003-03-20,Thomasville,Connecticut,29634,600,600,0,9/2/2021 18:12,1/22/2022 19:12
4664,1960-07-11,Thomasville,Delaware,29634,320,320,0,9/2/2021 18:14,5/9/2022 18:22
4665,1980-10-09,Thomasville,District of Columbia,29634,320,820,500,9/2/2021 18:21,4/8/2022 11:49
4666,1959-09-09,Thomasville,Florida,29634,800,800,0,9/2/2021 18:21,1/17/2022 21:06
4667,1971-04-18,Thomasville,Georgia,29634,300,300,0,9/2/2021 18:23,2/19/2022 12:13
4668,1983-07-20,Thomasville,Hawaii,29634,650,1150,500,9/2/2021 18:34,2/1/2022 20:01
4669,1963-03-09,Thomasville,Idaho,29634,900,900,0,9/2/2021 18:36,2/19/2022 11:07
4670,1999-01-28,Thomasville,Illinois,29634,450,450,0,9/2/2021 18:38,3/19/2022 14:33
4671,2003-01-09,Thomasville,Indiana,29634,750,750,0,9/2/2021 18:44,3/19/2022 16:51
4672,1981-05-16,Thomasville,Iowa,29634,400,400,0,9/2/2021 18:45,1/12/2022 12:27
4673,1972-05-07,Thomasville,Kansas,29634,320,320,0,9/2/2021 18:45,5/30/2022 21:33
4674,1999-06-30,Thomasville,Kentucky,29634,560,560,0,9/2/2021 18:47,5/23/2022 20:23
4675,2004-05-10,Thomasville,Louisiana,29634,460,460,0,9/2/2021 18:47,4/8/2022 21:52
4676,1986-04-19,Thomasville,Maine,29634,300,300,0,9/2/2021 18:49,2/1/2022 15:23
4677,1952-03-18,Thomasville,Maryland,29634,1650,1650,0,9/2/2021 18:49,2/6/2022 1:31
4678,1988-02-14,Thomasville,Massachusetts,29634,750,750,0,9/2/2021 18:49,1/21/2022 10:00
4679,1995-08-16,Thomasville,Michigan,29634,1150,1150,0,9/2/2021 18:50,2/19/2022 21:05
4680,2002-12-07,Thomasville,Minnesota,29634,800,800,0,9/2/2021 18:52,4/4/2022 23:56
4681,1995-01-20,Thomasville,Mississippi,29634,18190,26690,8500,9/2/2021 18:54,6/24/2022 14:26
4682,1983-05-27,Thomasville,Missouri,29634,560,560,0,9/2/2021 18:55,6/8/2022 18:24
4683,2000-09-30,Thomasville,Montana,29634,1270,1270,0,9/2/2021 18:57,4/15/2022 18:31
4684,1952-12-10,Thomasville,Nebraska,29634,300,300,0,9/2/2021 18:58,1/24/2022 18:12
4685,1979-12-28,Thomasville,Nevada,29634,170,9670,9500,9/2/2021 18:58,5/20/2022 1:22
4686,1957-12-01,Thomasville,New Hampshire,29634,350,350,0,9/2/2021 18:58,1/12/2022 18:31
4687,1979-04-08,Thomasville,New Jersey,29634,550,550,0,9/2/2021 18:59,3/22/2022 17:23
4688,1979-09-25,Thomasville,New Mexico,29634,310,310,0,9/2/2021 19:00,5/3/2022 19:16
4689,1996-10-02,Thomasville,New York,29634,950,950,0,9/2/2021 19:00,1/12/2022 19:15
4690,1968-03-21,Thomasville,North Carolina,29634,510,510,0,9/2/2021 19:02,4/19/2022 18:03
4691,1955-02-04,Thomasville,North Dakota,29634,500,500,0,9/2/2021 19:02,3/2/2022 18:52
4692,1982-11-02,Thomasville,Ohio,29634,1730,1730,0,9/2/2021 19:03,5/8/2022 12:19
4693,1961-09-06,Thomasville,Oklahoma,29634,720,720,0,9/2/2021 19:03,5/9/2022 12:58
4694,1983-09-13,Thomasville,Oregon,29634,310,310,0,9/2/2021 19:04,4/22/2022 12:15
4695,1992-03-28,Thomasville,Pennsylvania,29634,510,510,0,9/2/2021 19:09,5/6/2022 11:53
4696,1998-10-10,Thomasville,Rhode Island,29634,920,920,0,9/2/2021 19:09,5/3/2022 19:16
4697,1978-05-02,Thomasville,South Carolina,29634,360,360,0,9/2/2021 19:09,4/15/2022 15:11
4698,1994-01-21,Thomasville,South Dakota,29634,860,860,0,9/2/2021 19:11,5/15/2022 17:26
4699,1990-10-01,Thomasville,Tennessee,29634,350,350,0,9/2/2021 19:13,9/27/2021 10:03
4700,1953-12-17,Thomasville,Texas,29634,350,350,0,9/2/2021 19:19,2/26/2022 18:17
4701,2003-01-10,Thomasville,Utah,29634,4140,4140,0,9/2/2021 19:20,6/14/2022 12:17
4702,1962-07-21,Thomasville,Vermont,29634,360,860,500,9/2/2021 19:20,4/8/2022 19:02
4703,2000-07-11,Thomasville,Virginia,29634,210,10710,10500,9/2/2021 19:27,4/27/2022 7:01
4704,2002-11-08,Thomasville,Washington,29634,1050,1550,500,9/2/2021 19:27,3/20/2022 10:52
4705,1968-05-01,Thomasville,West Virginia,29634,1160,1160,0,9/2/2021 19:28,5/26/2022 22:15
4706,2021-06-23,Thomasville,Wisconsin,29634,2130,2130,0,9/2/2021 19:29,5/18/2022 11:18
4707,1962-01-04,Thomasville,Wyoming,29634,2100,2100,0,9/2/2021 19:29,3/27/2022 13:02
4708,1950-03-15,Thomasville,Alabama,29634,1050,1050,0,9/2/2021 19:30,2/25/2022 19:19
4709,2004-07-14,Thomasville,Alaska,29634,300,800,500,9/2/2021 19:32,1/12/2022 18:50
4710,1991-01-28,Thomasville,Arizona,29634,300,300,0,9/2/2021 19:34,1/12/2022 12:52
4711,2003-11-21,Thomasville,Arkansas,29634,400,400,0,9/2/2021 19:37,3/2/2022 17:56
4712,1976-05-21,Thomasville,California,29634,760,760,0,9/2/2021 19:38,4/20/2022 17:17
4713,1964-12-10,Thomasville,Colorado,29634,810,1310,500,9/2/2021 19:42,5/3/2022 18:00
4714,1981-12-28,Thomasville,Connecticut,29634,350,850,500,9/2/2021 19:42,3/5/2022 17:18
4715,1953-10-24,Thomasville,Delaware,29634,300,300,0,9/2/2021 19:44,11/20/2021 15:35
4716,1984-12-27,Thomasville,District of Columbia,29634,580,580,0,9/2/2021 19:46,4/18/2022 11:16
4717,1950-05-16,Thomasville,Florida,29634,300,300,0,9/2/2021 19:49,11/11/2021 10:45
4718,2004-11-24,Thomasville,Georgia,29634,460,460,0,9/2/2021 19:51,5/22/2022 17:19
4719,1995-06-07,Thomasville,Hawaii,29634,360,860,500,9/2/2021 20:03,2/25/2022 17:34
4720,1953-09-22,Thomasville,Idaho,29634,1150,1150,0,9/2/2021 20:03,12/23/2021 12:52
4721,1995-05-23,Thomasville,Illinois,29634,1510,1510,0,9/2/2021 20:06,4/9/2022 14:36
4722,2000-11-06,Thomasville,Indiana,29634,30,6850,6820,9/2/2021 20:08,5/9/2022 21:55
4723,1989-07-25,Thomasville,Iowa,29634,760,760,0,9/2/2021 20:09,5/11/2022 13:38
4724,2000-02-16,Thomasville,Kansas,29634,1250,1250,0,9/2/2021 20:09,6/6/2022 20:06
4725,1993-10-21,Thomasville,Kentucky,29634,800,800,0,9/2/2021 20:15,2/26/2022 18:46
4726,1982-01-15,Thomasville,Louisiana,29634,820,820,0,9/2/2021 20:16,4/15/2022 18:18
4727,1964-07-26,Thomasville,Maine,29634,650,650,0,9/2/2021 20:23,11/30/2021 18:28
4728,1965-05-19,Thomasville,Maryland,29634,400,400,0,9/2/2021 20:25,1/23/2022 8:28
4729,1980-03-16,Thomasville,Massachusetts,29634,360,360,0,9/2/2021 20:26,4/8/2022 12:13
4730,2002-09-19,Thomasville,Michigan,29634,360,360,0,9/2/2021 20:42,5/26/2022 21:12
4731,1974-05-11,Thomasville,Minnesota,29634,300,300,0,9/2/2021 20:43,10/30/2021 16:43
4732,1998-10-05,Thomasville,Mississippi,29634,300,300,0,9/2/2021 20:45,1/12/2022 10:20
4733,1995-05-19,Thomasville,Missouri,29634,350,350,0,9/2/2021 20:46,2/2/2022 10:31
4734,1991-11-16,Thomasville,Montana,29634,950,950,0,9/2/2021 20:54,2/26/2022 19:21
4735,1971-05-26,Thomasville,Nebraska,29634,310,310,0,9/2/2021 20:55,4/29/2022 20:29
4736,1986-06-25,Thomasville,Nevada,29634,450,450,0,9/2/2021 20:55,1/12/2022 19:09
4737,1953-08-12,Thomasville,New Hampshire,29634,1610,1610,0,9/2/2021 20:57,4/29/2022 23:52
4738,1999-03-10,Thomasville,New Jersey,29634,2330,2330,0,9/2/2021 20:57,12/4/2021 20:53
4739,1962-04-06,Thomasville,New Mexico,29634,600,600,0,9/2/2021 20:58,4/6/2022 10:10
4740,2000-10-23,Thomasville,New York,29634,2770,2770,0,9/2/2021 20:58,4/15/2022 18:48
4741,1953-02-21,Thomasville,North Carolina,29634,400,400,0,9/2/2021 21:00,10/30/2021 16:13
4742,1961-03-03,Thomasville,North Dakota,29634,1050,1050,0,9/2/2021 21:01,1/25/2022 15:23
4743,1969-03-08,Thomasville,Ohio,29634,900,900,0,9/2/2021 21:02,3/24/2022 14:30
4744,1974-01-27,Thomasville,Oklahoma,29634,1000,1000,0,9/2/2021 21:05,3/19/2022 11:47
4745,1960-10-21,Thomasville,Oregon,29634,600,1100,500,9/2/2021 21:06,3/6/2022 23:42
4746,1993-12-18,Thomasville,Pennsylvania,29634,1800,1800,0,9/2/2021 21:06,3/7/2022 18:57
4747,1995-04-17,Thomasville,Rhode Island,29634,320,320,0,9/2/2021 21:06,4/23/2022 20:58
4748,2005-12-17,Thomasville,South Carolina,29634,930,930,0,9/2/2021 21:06,5/12/2022 23:50
4749,2000-08-23,Thomasville,South Dakota,29634,350,350,0,9/2/2021 21:09,10/1/2021 15:31
4750,1970-11-14,Thomasville,Tennessee,29634,410,1410,1000,9/2/2021 21:14,6/18/2022 21:04
4751,1961-10-11,Thomasville,Texas,29634,350,350,0,9/2/2021 21:17,9/3/2021 19:41
4752,1978-10-18,Thomasville,Utah,29634,860,860,0,9/2/2021 21:23,4/15/2022 14:03
4753,1953-07-17,Thomasville,Vermont,29634,550,550,0,9/2/2021 21:25,3/14/2022 23:32
4754,1957-07-26,Thomasville,Virginia,29634,300,300,0,9/2/2021 21:25,2/26/2022 19:50
4755,1987-04-04,Thomasville,Washington,29634,1160,1160,0,9/2/2021 21:31,3/7/2022 15:36
4756,1950-08-19,Thomasville,West Virginia,29634,1040,1040,0,9/2/2021 21:31,5/7/2022 16:50
4757,1965-09-28,Thomasville,Wisconsin,29634,5240,5240,0,9/2/2021 21:35,6/29/2022 21:54
4758,1955-10-13,Thomasville,Wyoming,29634,750,750,0,9/2/2021 21:37,1/22/2022 17:55
4759,1965-05-15,Thomasville,Alabama,29634,300,300,0,9/2/2021 21:49,9/18/2021 18:15
4760,1970-08-02,Thomasville,Alaska,29634,300,300,0,9/2/2021 21:58,1/19/2022 10:31
4761,2002-03-14,Thomasville,Arizona,29634,550,550,0,9/2/2021 22:03,1/20/2022 11:34
4762,1975-08-18,Thomasville,Arkansas,29634,1610,1610,0,9/2/2021 22:03,4/10/2022 9:38
4763,2003-12-15,Thomasville,California,29634,2520,2520,0,9/2/2021 22:05,7/1/2022 4:16
4764,1991-12-01,Thomasville,Colorado,29634,300,300,0,9/2/2021 22:08,9/3/2021 18:55
4765,1992-08-07,Thomasville,Connecticut,29634,460,460,0,9/2/2021 22:09,9/3/2021 20:17
4766,1999-09-01,Thomasville,Delaware,29634,410,410,0,9/2/2021 22:12,5/20/2022 11:40
4767,1974-04-23,Thomasville,District of Columbia,29634,300,300,0,9/2/2021 22:14,10/15/2021 20:50
4768,2001-05-13,Thomasville,Florida,29634,2040,2040,0,9/2/2021 22:23,6/30/2022 22:18
4769,2002-05-20,Thomasville,Georgia,29634,350,350,0,9/2/2021 22:24,10/28/2021 21:47
4770,1980-08-12,Thomasville,Hawaii,29634,450,450,0,9/2/2021 22:26,2/14/2022 12:07
4771,1961-07-20,Thomasville,Idaho,29634,300,300,0,9/2/2021 22:29,9/3/2021 17:57
4772,1998-09-03,Thomasville,Illinois,29634,450,450,0,9/2/2021 22:30,3/29/2022 19:28
4773,2000-09-06,Thomasville,Indiana,29634,750,750,0,9/2/2021 22:37,3/26/2022 16:31
4774,1976-03-13,Thomasville,Iowa,29634,320,320,0,9/2/2021 22:43,6/27/2022 12:51
4775,1971-11-07,Thomasville,Kansas,29634,300,300,0,9/2/2021 22:46,10/15/2021 19:04
4776,1996-08-20,Thomasville,Kentucky,29634,350,350,0,9/2/2021 22:47,1/12/2022 16:58
4777,1981-04-01,Thomasville,Louisiana,29634,3740,3740,0,9/2/2021 22:48,5/3/2022 18:35
4778,1973-06-23,Thomasville,Maine,29634,300,300,0,9/2/2021 22:55,1/12/2022 14:19
4779,2001-01-03,Thomasville,Maryland,29634,60,560,500,9/2/2021 22:57,6/16/2022 17:58
4780,1969-10-07,Thomasville,Massachusetts,29634,20,520,500,9/2/2021 22:58,4/27/2022 9:51
4781,1965-09-14,Thomasville,Michigan,29634,560,1060,500,9/2/2021 23:01,4/16/2022 16:40
4782,1992-07-07,Thomasville,Minnesota,29634,350,350,0,9/2/2021 23:01,3/2/2022 21:02
4783,1984-07-17,Thomasville,Mississippi,29634,350,350,0,9/2/2021 23:02,1/12/2022 16:52
4784,2000-04-06,Thomasville,Missouri,29634,360,360,0,9/2/2021 23:20,4/22/2022 11:03
4785,1974-07-05,Thomasville,Montana,29634,350,350,0,9/2/2021 23:24,1/11/2022 18:01
4786,1974-03-02,Thomasville,Nebraska,29634,300,300,0,9/2/2021 23:31,10/25/2021 19:21
4787,1956-12-11,Thomasville,Nevada,29634,300,300,0,9/2/2021 23:43,9/24/2021 17:13
4788,1975-03-18,Thomasville,New Hampshire,29634,300,300,0,9/2/2021 23:44,2/12/2022 11:21
4789,1997-05-18,Thomasville,New Jersey,29634,1330,3830,2500,9/2/2021 23:48,6/2/2022 13:16
4790,1995-11-01,Thomasville,New Mexico,29634,360,360,0,9/2/2021 23:49,5/30/2022 10:54
4791,1983-06-17,Thomasville,New York,29634,1100,1600,500,9/3/2021 0:03,3/24/2022 13:53
4792,1973-08-25,Thomasville,North Carolina,29634,660,660,0,9/3/2021 0:29,4/20/2022 9:24
4793,1962-12-08,Thomasville,North Dakota,29634,410,410,0,9/3/2021 0:33,4/18/2022 10:57
4794,2004-09-23,Thomasville,Ohio,29634,510,510,0,9/3/2021 0:51,5/1/2022 15:14
4795,1999-04-26,Winston-Salem,North Carolina,27106,2400,5400,3000,9/3/2021 1:30,5/11/2022 13:01
4796,1961-02-08,Thomasville,Oklahoma,29634,300,300,0,9/3/2021 1:55,2/26/2022 16:45
4797,1986-06-24,Thomasville,Oregon,29634,500,500,0,9/3/2021 2:20,3/2/2022 20:28
4798,2000-11-10,Thomasville,Pennsylvania,29634,1150,1150,0,9/3/2021 9:19,2/19/2022 12:19
4799,1954-05-09,Thomasville,Rhode Island,29634,300,300,0,9/3/2021 9:22,2/24/2022 13:11
4800,1992-09-18,Thomasville,South Carolina,29634,600,600,0,9/3/2021 9:24,2/24/2022 13:35
4801,1986-01-14,Thomasville,South Dakota,29634,960,960,0,9/3/2021 9:25,5/3/2022 20:32
4802,1957-05-16,Thomasville,Tennessee,29634,300,300,0,9/3/2021 9:28,3/7/2022 22:47
4803,1977-05-08,Thomasville,Texas,29634,300,300,0,9/3/2021 9:30,11/30/2021 17:00
4804,1960-03-14,Thomasville,Utah,29634,1150,1150,0,9/3/2021 9:40,3/2/2022 21:14
4805,1959-02-08,Thomasville,Vermont,29634,500,500,0,9/3/2021 9:40,3/22/2022 15:49
4806,2002-08-31,Thomasville,Virginia,29634,420,420,0,9/3/2021 9:44,4/14/2022 0:33
4807,2002-11-03,Thomasville,Washington,29634,350,350,0,9/3/2021 9:48,1/21/2022 15:16
4808,2000-05-12,Thomasville,West Virginia,29634,1300,1300,0,9/3/2021 9:48,3/2/2022 21:20
4809,1993-05-21,Thomasville,Wisconsin,29634,1000,1000,0,9/3/2021 9:50,1/27/2022 18:50
4810,1978-04-16,Thomasville,Wyoming,29634,310,310,0,9/3/2021 9:51,4/16/2022 16:46
4811,1963-02-25,Thomasville,Alabama,29634,710,710,0,9/3/2021 9:58,6/16/2022 3:11
4812,1964-03-06,Thomasville,Alaska,29634,350,350,0,9/3/2021 9:58,9/7/2021 19:04
4813,1965-01-27,Thomasville,Arizona,29634,2170,2170,0,9/3/2021 9:58,6/10/2022 8:38
4814,1970-05-03,Thomasville,Arkansas,29634,350,350,0,9/3/2021 9:59,11/7/2021 17:35
4815,1996-03-05,Thomasville,California,29634,2250,2250,0,9/3/2021 10:00,3/25/2022 17:43
4816,1996-06-15,Thomasville,Colorado,29634,480,480,0,9/3/2021 10:00,5/31/2022 13:18
4817,1969-04-10,Thomasville,Connecticut,29634,810,810,0,9/3/2021 10:02,4/10/2022 12:59
4818,1982-02-04,Thomasville,Delaware,29634,660,660,0,9/3/2021 10:05,6/24/2022 15:24
4819,1976-01-28,Thomasville,District of Columbia,29634,400,400,0,9/3/2021 10:07,3/8/2022 14:05
4820,1975-08-23,Thomasville,Florida,29634,1200,1200,0,9/3/2021 10:08,3/13/2022 17:38
4821,1997-04-09,Thomasville,Georgia,29634,300,300,0,9/3/2021 10:13,12/7/2021 2:18
4822,1960-10-07,Thomasville,Hawaii,29634,400,400,0,9/3/2021 10:13,2/26/2022 18:12
4823,2002-09-10,Winston-Salem,North Carolina,27104,1690,1690,0,9/3/2021 10:14,5/17/2022 21:51
4824,1999-06-09,Winston-Salem,North Carolina,29204,400,400,0,9/3/2021 10:15,11/18/2021 14:03
4825,1975-08-05,Thomasville,Idaho,29634,350,350,0,9/3/2021 10:18,10/23/2021 16:37
4826,1985-08-01,Thomasville,Illinois,29634,400,400,0,9/3/2021 10:19,9/6/2021 23:22
4827,1960-04-03,Thomasville,Indiana,29634,660,660,0,9/3/2021 10:20,4/15/2022 19:32
4828,1972-01-02,Thomasville,Iowa,29634,350,350,0,9/3/2021 10:22,3/4/2022 20:49
4829,2002-11-14,Thomasville,Kansas,29634,990,990,0,9/3/2021 10:22,6/23/2022 6:45
4830,1987-03-09,Thomasville,Kentucky,29634,300,300,0,9/3/2021 10:29,3/27/2022 11:39
4831,1990-03-04,Thomasville,Louisiana,29634,300,300,0,9/3/2021 10:34,2/19/2022 13:09
4832,2001-10-14,Thomasville,Maine,29634,300,300,0,9/3/2021 10:37,1/22/2022 20:02
4833,1994-02-27,Thomasville,Maryland,29634,310,310,0,9/3/2021 10:39,6/7/2022 22:52
4834,1952-06-06,Thomasville,Massachusetts,29634,1230,1230,0,9/3/2021 10:44,6/1/2022 23:30
4835,1966-08-04,Thomasville,Michigan,29634,300,300,0,9/3/2021 10:47,9/18/2021 13:08
4836,1952-03-05,Thomasville,Minnesota,29634,1100,1100,0,9/3/2021 10:48,3/4/2022 15:12
4837,1985-08-03,Thomasville,Mississippi,29634,300,300,0,9/3/2021 10:49,2/5/2022 12:08
4838,1962-10-01,Thomasville,Missouri,29634,300,300,0,9/3/2021 10:58,3/19/2022 17:36
4839,1974-08-04,Thomasville,Montana,29634,300,300,0,9/3/2021 10:58,3/1/2022 18:33
4840,1973-11-17,Thomasville,Nebraska,29634,2620,2620,0,9/3/2021 11:00,6/26/2022 1:01
4841,1973-04-23,Thomasville,Nevada,29634,310,310,0,9/3/2021 11:00,4/9/2022 14:11
4842,1988-12-20,Winston-Salem,North Carolina,27106,1270,1270,0,9/3/2021 11:02,10/30/2021 18:50
4843,1970-10-23,Thomasville,New Hampshire,29634,350,350,0,9/3/2021 11:02,1/22/2022 11:17
4844,1971-11-24,Thomasville,New Jersey,29634,350,350,0,9/3/2021 11:03,1/19/2022 13:01
4845,2000-08-22,Thomasville,New Mexico,29634,550,550,0,9/3/2021 11:04,1/31/2022 12:13
4846,1972-04-28,Thomasville,New York,29634,300,300,0,9/3/2021 11:04,9/3/2021 18:37
4847,2003-07-05,Thomasville,North Carolina,29634,460,460,0,9/3/2021 11:06,12/4/2021 12:34
4848,1993-12-08,Thomasville,North Dakota,29634,600,600,0,9/3/2021 11:06,1/11/2022 19:14
4849,1964-06-05,Thomasville,Ohio,29634,250,750,500,9/3/2021 11:06,3/1/2022 10:14
4850,1970-06-06,Thomasville,Oklahoma,29634,350,350,0,9/3/2021 11:07,11/2/2021 23:56
4851,2002-04-03,Thomasville,Oregon,29634,1210,1210,0,9/3/2021 11:08,5/26/2022 20:08
4852,1967-02-28,Thomasville,Pennsylvania,29634,50,1050,1000,9/3/2021 11:09,2/26/2022 19:10
4853,2000-11-30,Thomasville,Rhode Island,29634,400,400,0,9/3/2021 11:13,3/25/2022 22:11
4854,1964-11-23,Thomasville,South Carolina,29634,310,310,0,9/3/2021 11:13,6/16/2022 20:44
4855,1959-11-11,Thomasville,South Dakota,29634,1890,1890,0,9/3/2021 11:13,6/30/2022 14:01
4856,1970-04-05,Thomasville,Tennessee,29634,610,610,0,9/3/2021 11:15,4/8/2022 20:04
4857,1985-11-22,Thomasville,Texas,29634,1300,1300,0,9/3/2021 11:16,3/26/2022 16:00
4858,2003-04-21,Thomasville,Utah,29634,1450,1450,0,9/3/2021 11:18,2/26/2022 18:54
4859,1987-03-12,Thomasville,Vermont,29634,1180,1180,0,9/3/2021 11:18,4/18/2022 16:40
4860,1974-12-21,Thomasville,Virginia,29634,410,410,0,9/3/2021 11:18,4/16/2022 17:10
4861,1957-02-14,Thomasville,Washington,29634,400,900,500,9/3/2021 11:18,1/22/2022 12:54
4862,1976-12-02,Thomasville,West Virginia,29634,300,300,0,9/3/2021 11:18,9/29/2021 18:00
4863,1985-12-19,Thomasville,Wisconsin,29634,350,350,0,9/3/2021 11:20,1/22/2022 20:09
4864,1952-11-27,Thomasville,Wyoming,29634,300,300,0,9/3/2021 11:21,3/19/2022 16:21
4865,1982-11-27,Thomasville,Alabama,29634,310,310,0,9/3/2021 11:21,4/13/2022 9:01
4866,2002-01-31,Thomasville,Alaska,29634,550,550,0,9/3/2021 11:25,1/22/2022 17:01
4867,1962-01-17,Thomasville,Arizona,29634,880,1380,500,9/3/2021 11:29,4/22/2022 9:21
4868,1966-07-26,Thomasville,Arkansas,29634,410,410,0,9/3/2021 11:30,4/9/2022 11:07
4869,1954-03-24,Thomasville,California,29634,300,300,0,9/3/2021 11:38,3/30/2022 16:19
4870,1986-09-02,Thomasville,Colorado,29634,350,350,0,9/3/2021 11:43,11/4/2021 11:45
4871,1960-09-25,Thomasville,Connecticut,29634,500,500,0,9/3/2021 11:45,2/26/2022 13:12
4872,1979-07-08,Thomasville,Delaware,29634,1470,1470,0,9/3/2021 11:46,4/16/2022 11:12
4873,1965-03-22,Thomasville,District of Columbia,29634,300,300,0,9/3/2021 11:48,12/29/2021 9:21
4874,1959-09-07,Thomasville,Florida,29634,2060,2060,0,9/3/2021 11:49,4/24/2022 12:29
4875,1993-06-24,Thomasville,Georgia,29634,350,350,0,9/3/2021 11:52,2/26/2022 15:46
4876,1985-05-16,Thomasville,Hawaii,29634,650,650,0,9/3/2021 11:52,3/2/2022 20:36
4877,1982-11-06,Thomasville,Idaho,29634,500,500,0,9/3/2021 11:55,1/25/2022 17:36
4878,1968-04-03,Thomasville,Illinois,29634,1130,1130,0,9/3/2021 11:57,1/22/2022 19:43
4879,1955-03-09,Thomasville,Indiana,29634,1050,1050,0,9/3/2021 11:58,2/12/2022 11:37
4880,1963-06-11,Thomasville,Iowa,29634,300,300,0,9/3/2021 11:58,11/8/2021 19:01
4881,1998-04-02,Thomasville,Kansas,29634,300,300,0,9/3/2021 12:02,10/29/2021 21:28
4882,2000-06-14,Thomasville,Kentucky,29634,310,310,0,9/3/2021 12:03,5/2/2022 18:03
4883,2003-10-06,Thomasville,Louisiana,29634,1860,1860,0,9/3/2021 12:04,4/16/2022 14:32
4884,1956-01-20,Thomasville,Maine,29634,300,300,0,9/3/2021 12:04,1/22/2022 10:07
4885,1995-12-26,Thomasville,Maryland,29634,1960,1960,0,9/3/2021 12:05,1/22/2022 19:31
4886,1965-03-04,Thomasville,Massachusetts,29634,360,360,0,9/3/2021 12:06,4/8/2022 9:00
4887,1950-03-18,Thomasville,Michigan,29634,300,300,0,9/3/2021 12:08,11/13/2021 19:49
4888,2003-07-10,Winston-Salem,North Carolina,27109,450,450,0,9/3/2021 12:18,3/28/2022 16:50
4889,1989-12-25,Thomasville,Minnesota,29634,2540,2540,0,9/3/2021 12:18,6/18/2022 12:04
4890,1989-04-20,Thomasville,Mississippi,29634,720,720,0,9/3/2021 12:19,5/12/2022 18:38
4891,1971-12-10,Thomasville,Missouri,29634,300,300,0,9/3/2021 12:20,11/18/2021 15:17
4892,1979-10-23,Thomasville,Montana,29634,750,750,0,9/3/2021 12:21,1/22/2022 16:29
4893,1996-09-19,Thomasville,Nebraska,29634,1680,1680,0,9/3/2021 12:21,5/14/2022 11:34
4894,1950-03-08,Thomasville,Nevada,29634,310,310,0,9/3/2021 12:24,4/13/2022 9:00
4895,1970-05-12,Thomasville,New Hampshire,29634,300,300,0,9/3/2021 12:28,1/19/2022 20:18
4896,1984-05-25,Thomasville,New Jersey,29634,310,310,0,9/3/2021 12:29,5/3/2022 17:39
4897,1966-02-07,Thomasville,New Mexico,29634,310,310,0,9/3/2021 12:32,4/19/2022 18:39
4898,1979-04-11,Thomasville,New York,29634,600,600,0,9/3/2021 12:32,1/17/2022 10:01
4899,1956-04-08,Thomasville,North Carolina,29634,300,300,0,9/3/2021 12:32,1/25/2022 14:01
4900,1957-12-17,Thomasville,North Dakota,29634,320,320,0,9/3/2021 12:32,4/27/2022 19:23
4901,2005-06-14,Thomasville,Ohio,29634,660,660,0,9/3/2021 12:33,4/8/2022 11:22
4902,1952-05-16,Thomasville,Oklahoma,29634,1260,1260,0,9/3/2021 12:33,4/8/2022 9:00
4903,1962-03-20,Thomasville,Oregon,29634,950,950,0,9/3/2021 12:35,3/2/2022 21:02
4904,2002-05-30,Thomasville,Pennsylvania,29634,1140,1140,0,9/3/2021 12:36,5/6/2022 14:54
4905,1965-10-23,Thomasville,Rhode Island,29634,300,300,0,9/3/2021 12:37,3/22/2022 10:57
4906,1958-06-25,Thomasville,South Carolina,29634,1200,1200,0,9/3/2021 12:37,3/15/2022 17:05
4907,2003-03-24,Thomasville,South Dakota,29634,400,400,0,9/3/2021 12:38,3/2/2022 20:49
4908,1962-10-08,Thomasville,Tennessee,29634,300,300,0,9/3/2021 12:40,3/12/2022 16:54
4909,1971-09-11,Thomasville,Texas,29634,1210,1210,0,9/3/2021 12:40,4/13/2022 8:07
4910,2002-01-07,Thomasville,Utah,29634,5360,5360,0,9/3/2021 12:41,5/7/2022 19:48
4911,1950-01-19,Thomasville,Vermont,29634,600,600,0,9/3/2021 12:42,3/13/2022 22:25
4912,2001-12-01,Thomasville,Virginia,29634,970,970,0,9/3/2021 12:42,5/26/2022 20:10
4913,2002-08-26,Thomasville,Washington,29634,1100,1100,0,9/3/2021 12:43,3/9/2022 20:53
4914,1984-02-05,Thomasville,West Virginia,29634,660,660,0,9/3/2021 12:44,5/3/2022 18:23
4915,2004-10-14,Thomasville,Wisconsin,29634,350,350,0,9/3/2021 12:45,9/3/2021 18:26
4916,1950-09-23,Thomasville,Wyoming,29634,330,330,0,9/3/2021 12:45,4/19/2022 18:36
4917,1988-09-19,Thomasville,Alabama,29634,1420,1420,0,9/3/2021 12:46,4/17/2022 15:58
4918,1993-02-22,Thomasville,Alaska,29634,2020,2020,0,9/3/2021 12:46,4/19/2022 18:31
4919,1984-12-14,Thomasville,Arizona,29634,320,320,0,9/3/2021 12:47,4/16/2022 16:40
4920,2001-06-29,Thomasville,Arkansas,29634,2840,2840,0,9/3/2021 12:48,5/10/2022 11:50
4921,1996-05-18,Thomasville,California,29634,1450,1450,0,9/3/2021 12:54,3/8/2022 14:05
4922,1960-06-07,Thomasville,Colorado,29634,350,350,0,9/3/2021 12:55,12/2/2021 15:01
4923,1953-12-16,Thomasville,Connecticut,29634,300,300,0,9/3/2021 12:56,9/26/2021 10:17
4924,2002-04-24,Thomasville,Delaware,29634,1610,1610,0,9/3/2021 12:56,6/30/2022 10:11
4925,1954-07-05,Thomasville,District of Columbia,29634,310,310,0,9/3/2021 12:57,6/17/2022 9:38
4926,2000-01-07,Thomasville,Florida,29634,700,700,0,9/3/2021 12:57,1/30/2022 22:54
4927,1993-11-04,Thomasville,Georgia,29634,300,300,0,9/3/2021 13:03,9/3/2021 20:40
4928,1991-10-18,Thomasville,Hawaii,29634,710,710,0,9/3/2021 13:04,6/9/2022 13:28
4929,1999-06-28,Thomasville,Idaho,29634,300,300,0,9/3/2021 13:07,1/22/2022 0:51
4930,1962-01-20,Thomasville,Illinois,29634,310,310,0,9/3/2021 13:08,4/29/2022 16:01
4931,1975-10-28,Thomasville,Indiana,29634,390,390,0,9/3/2021 13:08,4/24/2022 0:37
4932,2000-08-06,Thomasville,Iowa,29634,300,300,0,9/3/2021 13:08,1/13/2022 19:16
4933,1973-12-14,Thomasville,Kansas,29634,680,680,0,9/3/2021 13:10,5/15/2022 17:59
4934,1992-03-27,Thomasville,Kentucky,29634,300,300,0,9/3/2021 13:11,3/12/2022 12:17
4935,1976-11-25,Thomasville,Louisiana,29634,900,900,0,9/3/2021 13:12,1/22/2022 20:25
4936,1974-03-25,Thomasville,Maine,29634,400,400,0,9/3/2021 13:15,1/22/2022 19:03
4937,1960-07-26,Thomasville,Maryland,29634,730,730,0,9/3/2021 13:17,5/26/2022 20:42
4938,1971-06-02,Thomasville,Massachusetts,29634,670,670,0,9/3/2021 13:17,5/8/2022 12:24
4939,1978-08-17,Thomasville,Michigan,29634,650,650,0,9/3/2021 13:18,2/12/2022 13:25
4940,1963-08-27,Thomasville,Minnesota,29634,750,750,0,9/3/2021 13:22,3/3/2022 18:19
4941,2000-11-11,Thomasville,Mississippi,29634,7110,7110,0,9/3/2021 13:22,6/30/2022 20:19
4942,1974-01-10,Thomasville,Missouri,29634,350,350,0,9/3/2021 13:24,2/24/2022 20:25
4943,1975-02-20,Thomasville,Montana,29634,600,600,0,9/3/2021 13:25,1/22/2022 18:08
4944,2001-08-16,Thomasville,Nebraska,29634,1170,1170,0,9/3/2021 13:27,5/11/2022 18:36
4945,1987-09-23,Thomasville,Nevada,29634,900,900,0,9/3/2021 13:31,1/22/2022 20:04
4946,1996-09-07,Thomasville,New Hampshire,29634,310,310,0,9/3/2021 13:31,4/8/2022 9:00
4947,1996-01-16,Thomasville,New Jersey,29634,800,800,0,9/3/2021 13:35,3/3/2022 13:23
4948,1976-08-28,Thomasville,New Mexico,29634,1390,1390,0,9/3/2021 13:39,5/6/2022 13:38
4949,1952-07-15,Thomasville,New York,29634,450,450,0,9/3/2021 13:40,1/22/2022 20:06
4950,1959-05-28,Thomasville,North Carolina,29634,500,500,0,9/3/2021 13:41,2/22/2022 19:43
4951,1955-07-26,Thomasville,North Dakota,29634,620,620,0,9/3/2021 13:41,4/8/2022 18:57
4952,1989-02-17,Thomasville,Ohio,29634,400,400,0,9/3/2021 13:42,3/16/2022 13:51
4953,2002-06-13,Thomasville,Oklahoma,29634,510,510,0,9/3/2021 13:43,4/7/2022 19:17
4954,1962-07-27,Thomasville,Oregon,29634,750,750,0,9/3/2021 13:44,3/13/2022 22:25
4955,2000-12-20,Thomasville,Pennsylvania,29634,1220,1220,0,9/3/2021 13:45,5/12/2022 13:49
4956,1993-10-25,Thomasville,Rhode Island,29634,300,300,0,9/3/2021 13:45,1/22/2022 19:13
4957,1966-04-07,Thomasville,South Carolina,29634,650,650,0,9/3/2021 13:48,2/6/2022 12:31
4958,2004-06-26,Thomasville,South Dakota,29634,900,900,0,9/3/2021 13:50,3/15/2022 19:35
4959,1989-06-15,Thomasville,Tennessee,29634,1570,1570,0,9/3/2021 13:51,4/8/2022 11:22
4960,1956-02-04,Thomasville,Texas,29634,700,700,0,9/3/2021 13:52,2/3/2022 19:40
4961,1983-07-18,Thomasville,Utah,29634,1480,1480,0,9/3/2021 13:53,6/30/2022 11:07
4962,1965-05-04,Thomasville,Vermont,29634,520,520,0,9/3/2021 13:53,5/26/2022 20:06
4963,1957-04-03,Thomasville,Virginia,29634,450,450,0,9/3/2021 13:55,1/21/2022 4:05
4964,1965-02-08,Thomasville,Washington,29634,400,400,0,9/3/2021 13:55,12/4/2021 11:37
4965,1981-05-02,Thomasville,West Virginia,29634,930,930,0,9/3/2021 13:55,4/15/2022 18:04
4966,1983-03-07,Thomasville,Wisconsin,29634,600,600,0,9/3/2021 13:55,3/26/2022 20:01
4967,2004-03-27,Thomasville,Wyoming,29634,450,450,0,9/3/2021 13:55,3/30/2022 11:01
4968,1983-12-22,Thomasville,Alabama,29634,350,350,0,9/3/2021 13:57,1/11/2022 10:45
4969,1999-03-22,Thomasville,Alaska,29634,970,970,0,9/3/2021 13:57,5/3/2022 17:35
4970,1989-12-17,Thomasville,Arizona,29634,1260,1260,0,9/3/2021 13:57,5/3/2022 17:54
4971,1969-09-12,Thomasville,Arkansas,29634,300,300,0,9/3/2021 13:58,11/27/2021 18:35
4972,1974-12-19,Thomasville,California,29634,300,300,0,9/3/2021 13:58,9/3/2021 16:44
4973,2000-10-15,Thomasville,Colorado,29634,1200,1200,0,9/3/2021 14:00,3/25/2022 18:25
4974,2000-12-06,Thomasville,Connecticut,29634,300,300,0,9/3/2021 14:01,1/27/2022 10:40
4975,1991-10-15,Thomasville,Delaware,29634,500,500,0,9/3/2021 14:02,10/12/2021 15:03
4976,1954-09-11,Thomasville,District of Columbia,29634,460,460,0,9/3/2021 14:03,4/18/2022 17:09
4977,1967-01-19,Thomasville,Florida,29634,310,310,0,9/3/2021 14:05,4/8/2022 18:58
4978,2004-06-04,Thomasville,Georgia,29634,910,910,0,9/3/2021 14:05,5/3/2022 17:35
4979,1966-11-09,Thomasville,Hawaii,29634,300,300,0,9/3/2021 14:10,3/26/2022 10:37
4980,1972-06-04,Thomasville,Idaho,29634,450,450,0,9/3/2021 14:11,10/23/2021 16:38
4981,1960-05-19,Thomasville,Illinois,29634,300,300,0,9/3/2021 14:31,3/2/2022 20:13
4982,1998-07-22,Thomasville,Indiana,29634,350,350,0,9/3/2021 14:36,2/17/2022 20:35
4983,1978-10-01,Thomasville,Iowa,29634,660,660,0,9/3/2021 14:39,4/19/2022 18:33
4984,1997-07-19,Thomasville,Kansas,29634,300,300,0,9/3/2021 14:40,9/3/2021 15:44
4985,1995-08-24,Thomasville,Kentucky,29634,650,650,0,9/3/2021 14:42,3/16/2022 15:34
4986,2002-10-06,Thomasville,Louisiana,29634,850,850,0,9/3/2021 14:42,3/31/2022 19:13
4987,2001-05-11,Thomasville,Maine,29634,900,900,0,9/3/2021 14:47,1/12/2022 19:11
4988,2004-10-24,Thomasville,Maryland,29634,750,750,0,9/3/2021 14:48,2/6/2022 11:12
4989,1957-03-07,Thomasville,Massachusetts,29634,400,400,0,9/3/2021 14:51,1/12/2022 18:23
4990,1986-02-07,Thomasville,Michigan,29634,1410,1410,0,9/3/2021 14:54,5/11/2022 19:55
4991,1958-08-08,Thomasville,Minnesota,29634,460,460,0,9/3/2021 14:54,6/22/2022 15:13
4992,2002-02-18,Thomasville,Mississippi,29634,850,850,0,9/3/2021 14:56,1/12/2022 19:05
4993,1951-04-07,Thomasville,Missouri,29634,2790,2790,0,9/3/2021 14:57,6/27/2022 0:54
4994,2002-03-11,Thomasville,Montana,29634,2060,2060,0,9/3/2021 14:57,5/3/2022 18:38
4995,1991-05-23,Thomasville,Nebraska,29634,350,350,0,9/3/2021 14:59,11/14/2021 13:24
4996,1986-02-05,Thomasville,Nevada,29634,460,460,0,9/3/2021 15:06,3/24/2022 18:00
4997,1987-09-01,Thomasville,New Hampshire,29634,1070,1070,0,9/3/2021 15:07,5/11/2022 18:44
4998,1957-01-26,Thomasville,New Jersey,29634,300,300,0,9/3/2021 15:09,1/22/2022 18:53
4999,2004-03-20,Thomasville,New Mexico,29634,300,300,0,9/3/2021 15:09,1/22/2022 13:06
5000,2002-07-18,Thomasville,New York,29634,1570,1570,0,9/3/2021 15:10,3/29/2022 10:58
5001,1991-11-09,Thomasville,North Carolina,29634,350,350,0,9/3/2021 15:13,11/20/2021 10:48
5002,1995-07-12,Thomasville,North Dakota,29634,1010,1010,0,9/3/2021 15:17,4/29/2022 16:10
5003,1984-01-14,Thomasville,Ohio,29634,660,660,0,9/3/2021 15:19,6/18/2022 10:35
5004,1958-02-10,Thomasville,Oklahoma,29634,1570,1570,0,9/3/2021 15:19,4/29/2022 18:08
5005,1976-01-04,Thomasville,Oregon,29634,300,300,0,9/3/2021 15:22,3/20/2022 20:02
5006,1980-03-06,Thomasville,Pennsylvania,29634,1500,1500,0,9/3/2021 15:22,3/17/2022 10:21
5007,1972-07-21,Thomasville,Rhode Island,29634,1090,1090,0,9/3/2021 15:22,4/19/2022 7:28
5008,1986-03-27,Thomasville,South Carolina,29634,500,500,0,9/3/2021 15:23,3/23/2022 9:05
5009,1954-06-13,Thomasville,South Dakota,29634,710,710,0,9/3/2021 15:23,4/12/2022 13:31
5010,2002-06-17,Thomasville,Tennessee,29634,950,950,0,9/3/2021 15:24,1/17/2022 9:11
5011,2002-11-25,Thomasville,Texas,29634,8830,8830,0,9/3/2021 15:25,5/6/2022 11:57
5012,2005-07-15,Thomasville,Utah,29634,300,300,0,9/3/2021 15:25,1/12/2022 10:50
5013,2001-12-15,Thomasville,Vermont,29634,450,450,0,9/3/2021 15:27,12/13/2021 19:45
5014,1999-12-06,Thomasville,Virginia,29634,550,550,0,9/3/2021 15:27,3/26/2022 10:40
5015,1977-03-10,Thomasville,Washington,29634,710,710,0,9/3/2021 15:27,11/30/2021 18:45
5016,2003-09-12,Thomasville,West Virginia,29634,320,320,0,9/3/2021 15:28,5/26/2022 20:13
5017,1963-08-24,Thomasville,Wisconsin,29634,350,350,0,9/3/2021 15:30,9/11/2021 11:24
5018,1982-09-22,Thomasville,Wyoming,29634,550,550,0,9/3/2021 15:31,1/12/2022 18:33
5019,2000-10-06,Thomasville,Alabama,29634,300,300,0,9/3/2021 15:32,11/27/2021 16:38
5020,2002-08-11,Thomasville,Alaska,29634,1900,1900,0,9/3/2021 15:33,6/28/2022 16:30
5021,2003-11-10,Thomasville,Arizona,29634,300,300,0,9/3/2021 15:33,2/16/2022 19:12
5022,1956-01-21,Thomasville,Arkansas,29634,350,350,0,9/3/2021 15:36,12/14/2021 18:35
5023,1950-01-07,Thomasville,California,29634,300,300,0,9/3/2021 15:39,2/26/2022 19:07
5024,1989-04-27,Thomasville,Colorado,29634,1100,1100,0,9/3/2021 15:39,11/21/2021 16:50
5025,1958-03-01,Thomasville,Connecticut,29634,400,400,0,9/3/2021 15:41,10/30/2021 8:55
5026,1980-03-20,Thomasville,Delaware,29634,2660,2660,0,9/3/2021 15:41,4/28/2022 12:30
5027,1974-04-22,Thomasville,District of Columbia,29634,360,360,0,9/3/2021 15:41,4/30/2022 17:40
5028,1951-01-06,Thomasville,Florida,29634,370,370,0,9/3/2021 15:41,5/10/2022 16:27
5029,1952-06-18,Thomasville,Georgia,29634,350,350,0,9/3/2021 15:42,9/3/2021 19:02
5030,2001-02-04,Thomasville,Hawaii,29634,910,910,0,9/3/2021 15:42,4/8/2022 18:06
5031,2001-06-03,Thomasville,Idaho,29634,2750,2750,0,9/3/2021 15:43,12/24/2021 16:27
5032,1977-05-14,Thomasville,Illinois,29634,310,310,0,9/3/2021 15:44,4/10/2022 15:08
5033,1958-05-15,Thomasville,Indiana,29634,350,350,0,9/3/2021 15:44,9/3/2021 18:50
5034,1979-11-14,Thomasville,Iowa,29634,460,460,0,9/3/2021 15:46,4/23/2022 20:15
5035,2004-10-06,Thomasville,Kansas,29634,3620,3620,0,9/3/2021 15:49,4/23/2022 19:34
5036,1988-11-14,Thomasville,Kentucky,29634,500,500,0,9/3/2021 15:49,1/4/2022 23:09
5037,1995-11-11,Thomasville,Louisiana,29634,450,450,0,9/3/2021 15:51,3/14/2022 9:02
5038,1955-01-11,Thomasville,Maine,29634,950,950,0,9/3/2021 15:52,2/28/2022 9:12
5039,2000-02-27,Thomasville,Maryland,29634,600,600,0,9/3/2021 15:52,3/11/2022 10:45
5040,2003-11-02,Thomasville,Massachusetts,29634,300,300,0,9/3/2021 15:54,3/9/2022 21:27
5041,1959-03-10,Thomasville,Michigan,29634,350,350,0,9/3/2021 15:56,9/3/2021 18:44
5042,1991-01-27,Thomasville,Minnesota,29634,300,300,0,9/3/2021 15:56,1/12/2022 18:21
5043,1975-12-02,Thomasville,Mississippi,29634,330,330,0,9/3/2021 15:57,5/30/2022 14:43
5044,1961-12-06,Thomasville,Missouri,29634,300,300,0,9/3/2021 15:57,10/4/2021 20:36
5045,1991-02-17,Thomasville,Montana,29634,300,300,0,9/3/2021 15:57,2/3/2022 15:05
5046,1951-01-09,Thomasville,Nebraska,29634,1980,1980,0,9/3/2021 15:59,5/3/2022 19:00
5047,2002-02-03,Thomasville,Nevada,29634,400,400,0,9/3/2021 16:02,3/28/2022 16:00
5048,1955-02-08,Thomasville,New Hampshire,29634,300,300,0,9/3/2021 16:03,9/3/2021 16:04
5049,1981-02-25,Thomasville,New Jersey,29634,400,400,0,9/3/2021 16:09,2/11/2022 20:20
5050,2001-01-21,Thomasville,New Mexico,29634,3320,3320,0,9/3/2021 16:09,4/10/2022 12:31
5051,1985-03-25,Thomasville,New York,29634,370,370,0,9/3/2021 16:10,5/11/2022 17:58
5052,1992-03-05,Thomasville,North Carolina,29634,350,350,0,9/3/2021 16:10,2/26/2022 17:01
5053,1980-10-02,Thomasville,North Dakota,29634,1680,1680,0,9/3/2021 16:11,5/3/2022 19:27
5054,2000-04-04,Thomasville,Ohio,29634,170,1170,1000,9/3/2021 16:11,3/17/2022 16:15
5055,1993-11-11,Thomasville,Oklahoma,29634,3910,3910,0,9/3/2021 16:11,5/28/2022 12:10
5056,1952-09-14,Thomasville,Oregon,29634,350,350,0,9/3/2021 16:11,6/1/2022 9:50
5057,1973-04-04,Thomasville,Pennsylvania,29634,1430,1430,0,9/3/2021 16:11,4/9/2022 10:46
5058,1997-08-11,Thomasville,Rhode Island,29634,1610,1610,0,9/3/2021 16:12,4/16/2022 16:41
5059,1990-08-23,Thomasville,South Carolina,29634,700,700,0,9/3/2021 16:12,1/22/2022 19:36
5060,1954-04-02,Thomasville,South Dakota,29634,350,350,0,9/3/2021 16:12,2/19/2022 17:58
5061,1974-09-05,Thomasville,Tennessee,29634,1460,1460,0,9/3/2021 16:13,4/19/2022 18:13
5062,1985-08-18,Thomasville,Texas,29634,1450,1450,0,9/3/2021 16:13,3/4/2022 12:42
5063,1979-03-09,Thomasville,Utah,29634,350,350,0,9/3/2021 16:13,2/23/2022 9:46
5064,1986-02-18,Thomasville,Vermont,29634,1450,1450,0,9/3/2021 16:13,3/16/2022 19:19
5065,1994-10-05,Thomasville,Virginia,29634,1060,1060,0,9/3/2021 16:13,5/3/2022 18:28
5066,1990-08-07,Thomasville,Washington,29634,670,670,0,9/3/2021 16:14,4/27/2022 10:40
5067,1999-04-06,Thomasville,West Virginia,29634,300,300,0,9/3/2021 16:14,12/20/2021 13:45
5068,1952-05-03,Thomasville,Wisconsin,29634,350,350,0,9/3/2021 16:14,2/12/2022 13:00
5069,1979-12-04,Thomasville,Wyoming,29634,700,700,0,9/3/2021 16:16,3/15/2022 14:26
5070,2003-08-16,Thomasville,Alabama,29634,750,750,0,9/3/2021 16:17,1/11/2022 23:23
5071,2005-04-25,Thomasville,Alaska,29634,850,850,0,9/3/2021 16:19,1/22/2022 20:08
5072,2005-10-28,Thomasville,Arizona,29634,350,350,0,9/3/2021 16:20,1/17/2022 11:55
5073,2000-05-26,Thomasville,Arkansas,29634,400,400,0,9/3/2021 16:20,3/14/2022 11:26
5074,1960-10-20,Thomasville,California,29634,450,450,0,9/3/2021 16:20,2/12/2022 9:32
5075,1961-02-09,Thomasville,Colorado,29634,1390,1390,0,9/3/2021 16:21,5/4/2022 21:48
5076,1966-05-05,Thomasville,Connecticut,29634,650,650,0,9/3/2021 16:21,3/2/2022 20:54
5077,1950-09-27,Thomasville,Delaware,29634,500,500,0,9/3/2021 16:21,3/26/2022 17:04
5078,1988-01-15,Thomasville,District of Columbia,29634,450,450,0,9/3/2021 16:21,1/12/2022 19:16
5079,1959-08-14,Thomasville,Florida,29634,810,810,0,9/3/2021 16:21,6/30/2022 2:47
5080,1969-05-14,Thomasville,Georgia,29634,350,350,0,9/3/2021 16:22,3/19/2022 10:52
5081,1989-09-17,Thomasville,Hawaii,29634,1350,1350,0,9/3/2021 16:24,2/26/2022 21:00
5082,1975-04-09,Thomasville,Idaho,29634,450,450,0,9/3/2021 16:24,3/19/2022 13:00
5083,1982-12-07,Thomasville,Illinois,29634,360,360,0,9/3/2021 16:26,5/11/2022 16:14
5084,2002-12-09,Thomasville,Indiana,29634,360,360,0,9/3/2021 16:27,1/24/2022 15:57
5085,2001-09-07,Thomasville,Iowa,29634,4320,4320,0,9/3/2021 16:28,4/29/2022 17:35
5086,1969-07-06,Thomasville,Kansas,29634,300,300,0,9/3/2021 16:29,12/4/2021 21:48
5087,2001-05-05,Thomasville,Kentucky,29634,1330,1330,0,9/3/2021 16:29,5/3/2022 15:38
5088,1962-02-10,Thomasville,Louisiana,29634,750,750,0,9/3/2021 16:30,1/12/2022 19:11
5089,1999-09-14,Thomasville,Maine,29634,400,400,0,9/3/2021 16:30,12/1/2021 23:52
5090,1975-04-02,Thomasville,Maryland,29634,1150,1150,0,9/3/2021 16:31,2/5/2022 22:24
5091,1989-05-14,Thomasville,Massachusetts,29634,1010,1010,0,9/3/2021 16:31,2/26/2022 21:06
5092,1970-01-13,Thomasville,Michigan,29634,450,450,0,9/3/2021 16:32,2/19/2022 14:14
5093,1982-05-15,Thomasville,Minnesota,29634,1520,1520,0,9/3/2021 16:33,5/11/2022 18:31
5094,1983-06-26,Thomasville,Mississippi,29634,1290,1290,0,9/3/2021 16:34,5/11/2022 19:37
5095,1997-07-04,Thomasville,Missouri,29634,350,350,0,9/3/2021 16:34,3/2/2022 22:37
5096,1996-07-22,Thomasville,Montana,29634,710,710,0,9/3/2021 16:35,4/18/2022 10:57
5097,1970-08-27,Thomasville,Nebraska,29634,1110,1110,0,9/3/2021 16:37,5/3/2022 17:43
5098,1956-10-03,Thomasville,Nevada,29634,1400,1400,0,9/3/2021 16:38,3/19/2022 15:48
5099,1999-07-16,Thomasville,New Hampshire,29634,300,300,0,9/3/2021 16:38,11/9/2021 16:27
5100,2005-10-03,Thomasville,New Jersey,29634,830,1330,500,9/3/2021 16:39,5/18/2022 19:25
5101,1984-09-23,Thomasville,New Mexico,29634,1530,1530,0,9/3/2021 16:39,4/19/2022 18:33
5102,1971-01-16,Thomasville,New York,29634,600,600,0,9/3/2021 16:40,1/12/2022 19:01
5103,1988-06-02,Thomasville,North Carolina,29634,300,300,0,9/3/2021 16:40,1/12/2022 19:05
5104,1962-11-21,Thomasville,North Dakota,29634,340,340,0,9/3/2021 16:40,5/20/2022 16:26
5105,1954-03-10,Thomasville,Ohio,29634,410,410,0,9/3/2021 16:42,4/30/2022 10:17
5106,1979-11-13,Thomasville,Oklahoma,29634,400,400,0,9/3/2021 16:42,9/6/2021 15:34
5107,2002-06-21,Thomasville,Oregon,29634,2300,2300,0,9/3/2021 16:43,3/24/2022 15:44
5108,1970-06-22,Thomasville,Pennsylvania,29634,350,850,500,9/3/2021 16:46,1/27/2022 11:30
5109,1962-10-12,Thomasville,Rhode Island,29634,450,450,0,9/3/2021 16:47,2/26/2022 12:27
5110,1980-08-19,Thomasville,South Carolina,29634,750,750,0,9/3/2021 16:47,3/28/2022 18:15
5111,1976-02-06,Thomasville,South Dakota,29634,1100,1100,0,9/3/2021 16:48,1/22/2022 20:04
5112,1975-09-03,Thomasville,Tennessee,29634,350,350,0,9/3/2021 16:49,1/22/2022 18:53
5113,2004-04-19,Thomasville,Texas,29634,300,300,0,9/3/2021 16:51,10/2/2021 10:46
5114,1987-08-25,Thomasville,Utah,29634,300,300,0,9/3/2021 16:51,1/12/2022 16:17
5115,1990-01-19,Thomasville,Vermont,29634,300,300,0,9/3/2021 16:51,1/22/2022 19:51
5116,1999-12-23,Thomasville,Virginia,29634,1090,1090,0,9/3/2021 16:52,5/4/2022 22:27
5117,1984-06-18,Thomasville,Washington,29634,350,350,0,9/3/2021 16:52,12/2/2021 15:05
5118,1971-05-09,Thomasville,West Virginia,29634,1100,1100,0,9/3/2021 16:52,3/14/2022 11:32
5119,1973-06-10,Thomasville,Wisconsin,29634,810,810,0,9/3/2021 16:52,5/9/2022 20:26
5120,2002-12-15,Thomasville,Wyoming,29634,450,450,0,9/3/2021 16:52,12/1/2021 15:04
5121,1976-01-15,Thomasville,Alabama,29634,350,350,0,9/3/2021 16:53,9/3/2021 18:42
5122,2001-09-28,Thomasville,Alaska,29634,1410,1410,0,9/3/2021 16:53,4/8/2022 10:49
5123,2000-07-17,Thomasville,Arizona,29634,1410,1410,0,9/3/2021 16:53,4/16/2022 16:04
5124,1959-06-07,Thomasville,Arkansas,29634,1860,1860,0,9/3/2021 16:54,4/17/2022 13:13
5125,1979-12-10,Thomasville,California,29634,710,710,0,9/3/2021 16:54,4/16/2022 16:54
5126,1982-03-12,Thomasville,Colorado,29634,0,500,500,9/3/2021 16:55,2/16/2022 11:14
5127,1992-11-08,Thomasville,Connecticut,29634,710,710,0,9/3/2021 16:55,4/16/2022 17:08
5128,1977-04-16,Thomasville,Delaware,29634,960,960,0,9/3/2021 16:55,4/16/2022 17:01
5129,1988-07-10,Thomasville,District of Columbia,29634,710,710,0,9/3/2021 16:56,4/5/2022 19:30
5130,1990-03-22,Thomasville,Florida,29634,310,310,0,9/3/2021 16:56,6/14/2022 16:17
5131,1988-01-02,Thomasville,Georgia,29634,300,300,0,9/3/2021 16:57,1/7/2022 11:56
5132,1998-03-23,Thomasville,Hawaii,29634,300,300,0,9/3/2021 16:57,10/13/2021 13:05
5133,1980-05-05,Thomasville,Idaho,29634,410,410,0,9/3/2021 16:57,9/9/2021 10:55
5134,2002-10-23,Thomasville,Illinois,29634,760,760,0,9/3/2021 16:57,1/12/2022 19:14
5135,1993-02-25,Thomasville,Indiana,29634,300,300,0,9/3/2021 16:58,11/19/2021 11:26
5136,1986-11-01,Thomasville,Iowa,29634,400,400,0,9/3/2021 16:58,1/23/2022 14:29
5137,2005-02-16,Thomasville,Kansas,29634,300,300,0,9/3/2021 16:59,9/3/2021 17:39
5138,1968-04-18,Thomasville,Kentucky,29634,550,550,0,9/3/2021 16:59,4/5/2022 17:07
5139,1998-04-22,Thomasville,Louisiana,29634,850,850,0,9/3/2021 17:00,1/31/2022 12:11
5140,1961-06-02,Thomasville,Maine,29634,800,800,0,9/3/2021 17:00,1/12/2022 19:10
5141,2001-10-03,Thomasville,Maryland,29634,1370,1370,0,9/3/2021 17:00,4/27/2022 11:15
5142,2005-12-06,Thomasville,Massachusetts,29634,600,600,0,9/3/2021 17:01,3/25/2022 17:26
5143,1969-04-06,Thomasville,Michigan,29634,350,350,0,9/3/2021 17:02,2/9/2022 17:09
5144,1959-03-14,Thomasville,Minnesota,29634,4940,4940,0,9/3/2021 17:04,5/6/2022 12:14
5145,1995-02-28,Thomasville,Mississippi,29634,510,510,0,9/3/2021 17:05,6/26/2022 17:52
5146,1993-07-13,Thomasville,Missouri,29634,400,900,500,9/3/2021 17:05,3/25/2022 17:19
5147,2003-02-05,Thomasville,Montana,29634,0,500,500,9/3/2021 17:05,2/26/2022 16:11
5148,1996-01-08,Thomasville,Nebraska,29634,750,750,0,9/3/2021 17:05,3/19/2022 16:12
5149,1985-09-06,Thomasville,Nevada,29634,400,400,0,9/3/2021 17:06,3/4/2022 20:28
5150,1956-03-08,Thomasville,New Hampshire,29634,500,500,0,9/3/2021 17:06,2/12/2022 14:03
5151,1960-02-20,Thomasville,New Jersey,29634,300,300,0,9/3/2021 17:07,2/26/2022 19:35
5152,1995-09-06,Thomasville,New Mexico,29634,400,400,0,9/3/2021 17:07,2/19/2022 20:01
5153,1974-03-19,Thomasville,New York,29634,400,400,0,9/3/2021 17:07,2/22/2022 13:43
5154,1997-06-07,Thomasville,North Carolina,29634,310,310,0,9/3/2021 17:09,6/3/2022 23:39
5155,1961-06-12,Thomasville,North Dakota,29634,1250,1250,0,9/3/2021 17:09,1/22/2022 19:15
5156,1967-11-27,Thomasville,Ohio,29634,200,700,500,9/3/2021 17:09,3/2/2022 20:11
5157,2004-05-28,Thomasville,Oklahoma,29634,400,400,0,9/3/2021 17:09,1/22/2022 19:11
5158,1983-11-08,Thomasville,Oregon,29634,530,530,0,9/3/2021 17:09,6/20/2022 15:47
5159,1994-03-28,Thomasville,Pennsylvania,29634,1460,1460,0,9/3/2021 17:09,4/19/2022 17:52
5160,1958-03-17,Thomasville,Rhode Island,29634,450,450,0,9/3/2021 17:09,1/20/2022 14:06
5161,2000-01-17,Thomasville,South Carolina,29634,310,310,0,9/3/2021 17:10,4/8/2022 8:59
5162,1965-10-09,Thomasville,South Dakota,29634,300,300,0,9/3/2021 17:10,2/28/2022 9:28
5163,1990-05-05,Thomasville,Tennessee,29634,450,450,0,9/3/2021 17:11,3/24/2022 19:20
5164,2001-02-27,Thomasville,Texas,29634,450,450,0,9/3/2021 17:12,2/4/2022 18:56
5165,1963-07-18,Thomasville,Utah,29634,350,350,0,9/3/2021 17:12,11/13/2021 9:33
5166,1972-01-22,Thomasville,Vermont,29634,2000,2000,0,9/3/2021 17:12,4/3/2022 20:17
5167,1952-09-16,Thomasville,Virginia,29634,1800,1800,0,9/3/2021 17:12,3/22/2022 19:08
5168,1964-05-11,Thomasville,Washington,29634,350,350,0,9/3/2021 17:12,2/12/2022 0:17
5169,1986-02-16,Thomasville,West Virginia,29634,300,300,0,9/3/2021 17:13,3/1/2022 22:45
5170,1976-03-16,Thomasville,Wisconsin,29634,360,360,0,9/3/2021 17:13,4/8/2022 9:00
5171,1952-12-15,Thomasville,Wyoming,29634,1100,1100,0,9/3/2021 17:14,3/26/2022 17:03
5172,1960-03-11,Thomasville,Alabama,29634,350,350,0,9/3/2021 17:15,9/3/2021 18:48
5173,1954-02-25,Thomasville,Alaska,29634,1060,1060,0,9/3/2021 17:15,6/24/2022 21:55
5174,1994-09-17,Thomasville,Arizona,29634,7230,7230,0,9/3/2021 17:16,4/19/2022 13:11
5175,1985-06-05,Thomasville,Arkansas,29634,350,350,0,9/3/2021 17:16,11/13/2021 12:35
5176,1999-11-19,Thomasville,California,29634,670,670,0,9/3/2021 17:16,5/6/2022 12:11
5177,2004-04-03,Thomasville,Colorado,29634,400,400,0,9/3/2021 17:16,1/22/2022 18:51
5178,2002-12-11,Thomasville,Connecticut,29634,3080,3080,0,9/3/2021 17:17,6/8/2022 17:36
5179,1978-02-13,Thomasville,Delaware,29634,600,600,0,9/3/2021 17:17,3/4/2022 10:12
5180,1985-03-26,Thomasville,District of Columbia,29634,1100,1100,0,9/3/2021 17:17,3/18/2022 21:07
5181,2004-01-04,Thomasville,Florida,29634,500,500,0,9/3/2021 17:17,11/13/2021 19:45
5182,1962-11-08,Thomasville,Georgia,29634,1780,1780,0,9/3/2021 17:17,4/19/2022 0:53
5183,1960-02-06,Thomasville,Hawaii,29634,300,300,0,9/3/2021 17:18,11/15/2021 16:25
5184,1975-02-16,Thomasville,Idaho,29634,2560,2560,0,9/3/2021 17:18,4/17/2022 11:31
5185,1970-04-15,Thomasville,Illinois,29634,1540,1540,0,9/3/2021 17:19,6/24/2022 22:55
5186,1960-09-15,Thomasville,Indiana,29634,400,400,0,9/3/2021 17:19,2/26/2022 19:42
5187,1980-03-18,Thomasville,Iowa,29634,300,300,0,9/3/2021 17:19,11/13/2021 18:37
5188,1983-09-26,Thomasville,Kansas,29634,350,350,0,9/3/2021 17:20,2/16/2022 9:12
5189,1958-12-15,Thomasville,Kentucky,29634,300,300,0,9/3/2021 17:20,2/19/2022 13:00
5190,1998-01-14,Thomasville,Louisiana,29634,650,650,0,9/3/2021 17:20,3/10/2022 12:09
5191,2003-01-16,Thomasville,Maine,29634,1870,1870,0,9/3/2021 17:22,4/19/2022 21:08
5192,1974-10-15,Thomasville,Maryland,29634,300,300,0,9/3/2021 17:22,3/5/2022 23:11
5193,1974-05-03,Thomasville,Massachusetts,29634,300,300,0,9/3/2021 17:22,1/22/2022 20:07
5194,2001-09-14,Thomasville,Michigan,29634,450,450,0,9/3/2021 17:23,11/13/2021 19:41
5195,1979-06-20,Thomasville,Minnesota,29634,1110,1110,0,9/3/2021 17:23,4/8/2022 21:57
5196,2003-12-19,Thomasville,Mississippi,29634,330,330,0,9/3/2021 17:23,5/10/2022 18:08
5197,1979-04-22,Thomasville,Missouri,29634,300,300,0,9/3/2021 17:23,10/30/2021 15:06
5198,1956-09-12,Thomasville,Montana,29634,750,750,0,9/3/2021 17:23,3/19/2022 16:12
5199,1967-09-10,Thomasville,Nebraska,29634,300,300,0,9/3/2021 17:23,3/5/2022 14:30
5200,2005-03-09,Thomasville,Nevada,29634,600,600,0,9/3/2021 17:24,1/22/2022 18:33
5201,1967-03-03,Thomasville,New Hampshire,29634,300,300,0,9/3/2021 17:24,2/26/2022 18:29
5202,1969-10-19,Thomasville,New Jersey,29634,310,310,0,9/3/2021 17:24,4/24/2022 18:27
5203,1989-06-17,Thomasville,New Mexico,29634,1670,1670,0,9/3/2021 17:25,5/11/2022 18:41
5204,1973-12-02,Thomasville,New York,29634,1210,1210,0,9/3/2021 17:25,2/17/2022 20:58
5205,2001-12-07,Thomasville,North Carolina,29634,1250,1250,0,9/3/2021 17:25,3/2/2022 20:49
5206,1983-08-15,Thomasville,North Dakota,29634,820,820,0,9/3/2021 17:25,5/3/2022 17:30
5207,1996-05-24,Thomasville,Ohio,29634,900,900,0,9/3/2021 17:25,3/14/2022 11:54
5208,1976-10-26,Thomasville,Oklahoma,29634,400,400,0,9/3/2021 17:25,1/22/2022 19:59
5209,1974-09-04,Thomasville,Oregon,29634,610,610,0,9/3/2021 17:26,4/29/2022 16:00
5210,1957-12-27,Thomasville,Pennsylvania,29634,1520,1520,0,9/3/2021 17:26,6/24/2022 21:34
5211,1989-07-13,Thomasville,Rhode Island,29634,610,610,0,9/3/2021 17:26,4/16/2022 16:41
5212,1980-02-03,Thomasville,South Carolina,29634,1000,1000,0,9/3/2021 17:26,3/24/2022 18:48
5213,1983-11-03,Thomasville,South Dakota,29634,450,450,0,9/3/2021 17:27,12/12/2021 19:05
5214,1960-08-27,Thomasville,Tennessee,29634,500,500,0,9/3/2021 17:27,2/25/2022 19:47
5215,1953-02-28,Thomasville,Texas,29634,350,350,0,9/3/2021 17:27,3/2/2022 19:46
5216,2003-01-05,Thomasville,Utah,29634,1280,1280,0,9/3/2021 17:27,6/15/2022 20:49
5217,1966-03-13,Thomasville,Vermont,29634,850,850,0,9/3/2021 17:27,3/2/2022 12:13
5218,1989-03-19,Thomasville,Virginia,29634,300,300,0,9/3/2021 17:27,11/13/2021 21:25
5219,2000-04-13,Thomasville,Washington,29634,850,850,0,9/3/2021 17:27,3/31/2022 11:39
5220,1966-03-01,Thomasville,West Virginia,29634,360,360,0,9/3/2021 17:27,6/29/2022 14:03
5221,1994-09-12,Thomasville,Wisconsin,29634,960,960,0,9/3/2021 17:28,4/18/2022 18:32
5222,1982-06-20,Thomasville,Wyoming,29634,720,720,0,9/3/2021 17:28,4/16/2022 15:18
5223,1976-03-28,Thomasville,Alabama,29634,1720,1720,0,9/3/2021 17:28,5/21/2022 20:16
5224,1954-02-08,Thomasville,Alaska,29634,350,350,0,9/3/2021 17:28,5/11/2022 18:32
5225,1958-03-03,Thomasville,Arizona,29634,750,750,0,9/3/2021 17:28,5/17/2022 14:31
5226,2004-05-07,Thomasville,Arkansas,29634,300,300,0,9/3/2021 17:29,12/3/2021 8:10
5227,2005-03-07,Thomasville,California,29634,300,300,0,9/3/2021 17:29,2/19/2022 15:24
5228,1991-09-19,Thomasville,Colorado,29634,300,300,0,9/3/2021 17:29,3/14/2022 10:54
5229,1973-03-02,Thomasville,Connecticut,29634,800,800,0,9/3/2021 17:30,2/19/2022 13:03
5230,1967-11-13,Thomasville,Delaware,29634,1210,1710,500,9/3/2021 17:30,4/30/2022 10:09
5231,1951-11-12,Thomasville,District of Columbia,29634,350,350,0,9/3/2021 17:30,3/2/2022 16:13
5232,1962-08-20,Thomasville,Florida,29634,350,350,0,9/3/2021 17:31,11/27/2021 15:36
5233,2004-11-18,Thomasville,Georgia,29634,350,350,0,9/3/2021 17:33,9/10/2021 15:18
5234,1961-11-15,Thomasville,Hawaii,29634,1420,1420,0,9/3/2021 17:33,5/3/2022 18:34
5235,1979-01-12,Thomasville,Idaho,29634,300,300,0,9/3/2021 17:33,12/2/2021 17:58
5236,1988-02-09,Thomasville,Illinois,29634,300,300,0,9/3/2021 17:34,3/25/2022 17:55
5237,1959-06-10,Thomasville,Indiana,29634,350,350,0,9/3/2021 17:34,1/10/2022 12:12
5238,1990-11-16,Thomasville,Iowa,29634,2140,2140,0,9/3/2021 17:34,5/3/2022 18:46
5239,1981-01-22,Thomasville,Kansas,29634,1470,1470,0,9/3/2021 17:35,2/22/2022 19:02
5240,1969-08-09,Thomasville,Kentucky,29634,900,900,0,9/3/2021 17:35,2/26/2022 19:10
5241,2004-12-24,Thomasville,Louisiana,29634,350,350,0,9/3/2021 17:36,11/13/2021 19:16
5242,1992-01-15,Thomasville,Maine,29634,610,610,0,9/3/2021 17:36,4/8/2022 11:22
5243,1995-05-02,Thomasville,Maryland,29634,700,700,0,9/3/2021 17:36,2/12/2022 14:46
5244,1968-11-27,Thomasville,Massachusetts,29634,1460,1460,0,9/3/2021 17:37,5/19/2022 19:54
5245,1984-09-14,Thomasville,Michigan,29634,1460,1460,0,9/3/2021 17:37,5/9/2022 16:35
5246,1989-05-17,Thomasville,Minnesota,29634,350,350,0,9/3/2021 17:37,9/3/2021 22:56
5247,1981-10-26,Thomasville,Mississippi,29634,650,650,0,9/3/2021 17:37,10/30/2021 13:19
5248,2001-11-01,Thomasville,Missouri,29634,800,800,0,9/3/2021 17:37,11/12/2021 16:01
5249,1989-01-05,Thomasville,Montana,29634,800,800,0,9/3/2021 17:37,2/25/2022 17:56
5250,1983-10-27,Thomasville,Nebraska,29634,310,310,0,9/3/2021 17:38,4/8/2022 10:50
5251,1984-07-23,Thomasville,Nevada,29634,220,720,500,9/3/2021 17:38,6/19/2022 11:16
5252,2004-04-22,Thomasville,New Hampshire,29634,660,660,0,9/3/2021 17:38,5/26/2022 20:41
5253,1986-09-10,Thomasville,New Jersey,29634,1150,1150,0,9/3/2021 17:39,3/27/2022 14:12
5254,1975-07-07,Thomasville,New Mexico,29634,10,510,500,9/3/2021 17:39,5/3/2022 18:13
5255,1986-10-13,Thomasville,New York,29634,1820,1820,0,9/3/2021 17:39,5/10/2022 13:14
5256,1950-03-15,Thomasville,North Carolina,29634,300,300,0,9/3/2021 17:39,1/18/2022 17:06
5257,1961-10-02,Thomasville,North Dakota,29634,200,700,500,9/3/2021 17:40,3/15/2022 18:40
5258,2003-03-11,Thomasville,Ohio,29634,1250,1250,0,9/3/2021 17:40,2/18/2022 18:14
5259,1983-05-06,Thomasville,Oklahoma,29634,550,550,0,9/3/2021 17:40,2/26/2022 19:10
5260,1978-02-10,Thomasville,Oregon,29634,720,720,0,9/3/2021 17:40,6/4/2022 17:44
5261,1991-06-01,Thomasville,Pennsylvania,29634,350,350,0,9/3/2021 17:40,9/27/2021 10:43
5262,2002-01-23,Thomasville,Rhode Island,29634,300,300,0,9/3/2021 17:41,2/26/2022 19:14
5263,2004-12-28,Thomasville,South Carolina,29634,410,410,0,9/3/2021 17:41,5/3/2022 18:04
5264,2002-02-13,Thomasville,South Dakota,29634,1010,1010,0,9/3/2021 17:41,5/10/2022 22:21
5265,1978-03-15,Thomasville,Tennessee,29634,300,300,0,9/3/2021 17:41,4/5/2022 18:23
5266,1982-12-14,Thomasville,Texas,29634,400,400,0,9/3/2021 17:42,11/27/2021 19:58
5267,1951-02-18,Thomasville,Utah,29634,600,600,0,9/3/2021 17:42,3/15/2022 16:40
5268,1971-01-12,Thomasville,Vermont,29634,900,900,0,9/3/2021 17:42,1/12/2022 17:33
5269,1996-11-15,Thomasville,Virginia,29634,300,300,0,9/3/2021 17:43,12/5/2021 1:05
5270,1977-06-07,Thomasville,Washington,29634,350,350,0,9/3/2021 17:43,11/13/2021 19:34
5271,1973-12-24,Thomasville,West Virginia,29634,660,660,0,9/3/2021 17:44,4/19/2022 14:20
5272,1986-07-02,Thomasville,Wisconsin,29634,300,300,0,9/3/2021 17:44,11/13/2021 17:53
5273,1955-05-23,Thomasville,Wyoming,29634,350,350,0,9/3/2021 17:44,2/16/2022 11:17
5274,1998-01-06,Thomasville,Alabama,29634,300,300,0,9/3/2021 17:44,1/21/2022 12:46
5275,1957-06-18,Thomasville,Alaska,29634,310,310,0,9/3/2021 17:44,4/18/2022 18:06
5276,1994-11-25,Thomasville,Arizona,29634,750,1250,500,9/3/2021 17:45,2/26/2022 19:18
5277,1980-07-06,Thomasville,Arkansas,29634,450,450,0,9/3/2021 17:45,11/14/2021 4:32
5278,1999-04-15,Thomasville,California,29634,750,750,0,9/3/2021 17:45,3/29/2022 16:00
5279,1970-10-22,Thomasville,Colorado,29634,300,300,0,9/3/2021 17:45,9/3/2021 18:33
5280,1987-03-22,Thomasville,Connecticut,29634,550,550,0,9/3/2021 17:45,2/26/2022 11:27
5281,1951-06-01,Thomasville,Delaware,29634,350,350,0,9/3/2021 17:45,11/13/2021 19:40
5282,1962-04-03,Thomasville,District of Columbia,29634,500,500,0,9/3/2021 17:46,3/13/2022 10:34
5283,1973-09-20,Thomasville,Florida,29634,560,560,0,9/3/2021 17:46,4/15/2022 19:42
5284,1972-08-27,Thomasville,Georgia,29634,510,510,0,9/3/2021 17:46,3/4/2022 20:41
5285,1987-10-25,Thomasville,Hawaii,29634,500,500,0,9/3/2021 17:47,2/19/2022 13:53
5286,1967-05-09,Thomasville,Idaho,29634,300,300,0,9/3/2021 17:47,11/30/2021 12:07
5287,1955-06-13,Thomasville,Illinois,29634,500,500,0,9/3/2021 17:48,3/15/2022 9:03
5288,1959-04-07,Thomasville,Indiana,29634,350,350,0,9/3/2021 17:48,3/24/2022 15:41
5289,1976-11-15,Thomasville,Iowa,29634,300,300,0,9/3/2021 17:48,4/6/2022 9:48
5290,1996-06-09,Thomasville,Kansas,29634,1000,1000,0,9/3/2021 17:49,1/22/2022 19:17
5291,1969-06-18,Thomasville,Kentucky,29634,300,300,0,9/3/2021 17:49,1/22/2022 14:34
5292,1986-02-26,Thomasville,Louisiana,29634,450,450,0,9/3/2021 17:50,1/12/2022 18:53
5293,1972-11-10,Thomasville,Maine,29634,850,850,0,9/3/2021 17:50,4/2/2022 14:18
5294,1959-11-26,Thomasville,Maryland,29634,1210,1210,0,9/3/2021 17:50,4/21/2022 14:25
5295,1950-07-04,Thomasville,Massachusetts,29634,300,300,0,9/3/2021 17:51,1/20/2022 17:24
5296,1955-08-25,Thomasville,Michigan,29634,400,400,0,9/3/2021 17:51,3/12/2022 11:10
5297,2001-12-25,Thomasville,Minnesota,29634,450,450,0,9/3/2021 17:51,4/6/2022 9:28
5298,1959-01-24,Thomasville,Mississippi,29634,300,300,0,9/3/2021 17:51,10/20/2021 12:48
5299,1978-05-17,Thomasville,Missouri,29634,550,550,0,9/3/2021 17:51,2/19/2022 14:10
5300,1997-04-07,Thomasville,Montana,29634,700,700,0,9/3/2021 17:51,2/28/2022 23:42
5301,1972-11-04,Thomasville,Nebraska,29634,2300,2300,0,9/3/2021 17:52,3/17/2022 19:04
5302,2021-06-18,San Marcos,California,92078,600,600,0,9/3/2021 17:53,3/2/2022 20:36
5303,1998-11-24,Thomasville,Nevada,29634,310,310,0,9/3/2021 17:53,4/18/2022 18:07
5304,2001-12-02,Thomasville,New Hampshire,29634,450,450,0,9/3/2021 17:53,2/17/2022 17:01
5305,1950-05-11,Thomasville,New Jersey,29634,1700,1700,0,9/3/2021 17:53,3/13/2022 17:47
5306,1978-02-24,Thomasville,New Mexico,29634,1120,1120,0,9/3/2021 17:54,4/8/2022 12:34
5307,1970-11-11,Thomasville,New York,29634,910,910,0,9/3/2021 17:54,4/18/2022 11:07
5308,2004-05-06,Thomasville,North Carolina,29634,3110,3110,0,9/3/2021 17:55,4/8/2022 19:16
5309,1968-02-28,Thomasville,North Dakota,29634,650,1150,500,9/3/2021 17:55,2/19/2022 13:06
5310,1984-06-15,Thomasville,Ohio,29634,450,450,0,9/3/2021 17:55,2/9/2022 19:14
5311,1983-11-04,Thomasville,Oklahoma,29634,720,720,0,9/3/2021 17:55,6/30/2022 16:01
5312,1988-10-04,Thomasville,Oregon,29634,500,500,0,9/3/2021 17:56,12/13/2021 10:52
5313,2005-11-19,Thomasville,Pennsylvania,29634,750,750,0,9/3/2021 17:56,1/12/2022 18:51
5314,1991-09-14,Thomasville,Rhode Island,29634,370,370,0,9/3/2021 17:56,6/16/2022 13:48
5315,1991-05-27,Thomasville,South Carolina,29634,1170,1170,0,9/3/2021 17:57,6/30/2022 22:27
5316,2003-02-28,Thomasville,South Dakota,29634,920,920,0,9/3/2021 17:59,4/20/2022 9:52
5317,1986-03-02,Thomasville,Tennessee,29634,1820,1820,0,9/3/2021 17:59,5/7/2022 16:40
5318,1964-11-03,Thomasville,Texas,29634,400,400,0,9/3/2021 17:59,11/27/2021 19:10
5319,1975-04-08,Thomasville,Utah,29634,310,310,0,9/3/2021 18:00,6/21/2022 11:37
5320,1975-09-10,Thomasville,Vermont,29634,500,500,0,9/3/2021 18:00,3/2/2022 9:16
5321,1978-11-23,Thomasville,Virginia,29634,350,350,0,9/3/2021 18:00,3/2/2022 22:59
5322,1988-02-05,Thomasville,Washington,29634,520,520,0,9/3/2021 18:01,6/11/2022 13:01
5323,1958-12-16,Thomasville,West Virginia,29634,300,300,0,9/3/2021 18:01,11/27/2021 19:02
5324,1959-06-09,Thomasville,Wisconsin,29634,760,760,0,9/3/2021 18:01,4/16/2022 17:14
5325,2000-04-07,Thomasville,Wyoming,29634,500,500,0,9/3/2021 18:01,10/5/2021 16:52
5326,1971-06-13,Thomasville,Alabama,29634,300,300,0,9/3/2021 18:02,1/22/2022 16:30
5327,1979-12-19,Thomasville,Alaska,29634,300,300,0,9/3/2021 18:03,2/26/2022 18:21
5328,2003-06-05,Thomasville,Arizona,29634,350,350,0,9/3/2021 18:03,11/28/2021 9:27
5329,2002-06-06,Thomasville,Arkansas,29634,320,320,0,9/3/2021 18:03,6/28/2022 11:13
5330,1967-09-28,Thomasville,California,29634,350,350,0,9/3/2021 18:03,11/30/2021 11:46
5331,1973-06-05,Thomasville,Colorado,29634,710,710,0,9/3/2021 18:03,4/15/2022 12:10
5332,2001-12-04,Thomasville,Connecticut,29634,1150,1150,0,9/3/2021 18:03,1/13/2022 14:39
5333,1982-09-02,Thomasville,Delaware,29634,350,350,0,9/3/2021 18:04,2/19/2022 11:24
5334,1969-04-11,Thomasville,District of Columbia,29634,610,610,0,9/3/2021 18:04,4/16/2022 16:44
5335,1984-11-27,Thomasville,Florida,29634,400,400,0,9/3/2021 18:04,6/22/2022 8:37
5336,1954-09-14,Thomasville,Georgia,29634,300,300,0,9/3/2021 18:04,11/27/2021 22:12
5337,2003-02-21,Thomasville,Hawaii,29634,350,350,0,9/3/2021 18:05,1/21/2022 20:33
5338,2003-01-21,Thomasville,Idaho,29634,460,460,0,9/3/2021 18:06,5/8/2022 19:43
5339,1979-08-11,Thomasville,Illinois,29634,1330,1330,0,9/3/2021 18:07,5/8/2022 9:54
5340,1970-11-04,Thomasville,Indiana,29634,400,400,0,9/3/2021 18:07,2/17/2022 11:35
5341,2000-05-07,Thomasville,Iowa,29634,450,450,0,9/3/2021 18:08,1/12/2022 19:05
5342,1959-11-07,Thomasville,Kansas,29634,500,500,0,9/3/2021 18:08,2/19/2022 12:29
5343,1962-10-08,Thomasville,Kentucky,29634,350,350,0,9/3/2021 18:08,2/19/2022 13:37
5344,1988-07-15,Thomasville,Louisiana,29634,2150,2150,0,9/3/2021 18:08,4/5/2022 22:16
5345,1963-05-10,Thomasville,Maine,29634,360,360,0,9/3/2021 18:09,5/7/2022 23:43
5346,1981-03-11,Thomasville,Maryland,29634,800,800,0,9/3/2021 18:09,3/17/2022 12:11
5347,1982-05-20,Thomasville,Massachusetts,29634,350,350,0,9/3/2021 18:11,2/16/2022 11:22
5348,1971-11-22,Thomasville,Michigan,29634,310,310,0,9/3/2021 18:12,4/8/2022 19:30
5349,1957-09-17,Thomasville,Minnesota,29634,250,750,500,9/3/2021 18:12,2/26/2022 18:47
5350,1977-03-21,Thomasville,Mississippi,29634,300,300,0,9/3/2021 18:12,2/1/2022 20:12
5351,1955-03-23,Thomasville,Missouri,29634,300,300,0,9/3/2021 18:12,9/3/2021 19:04
5352,1977-08-18,Thomasville,Montana,29634,850,850,0,9/3/2021 18:12,1/12/2022 18:56
5353,1968-12-03,Thomasville,Nebraska,29634,650,650,0,9/3/2021 18:13,2/12/2022 14:12
5354,1983-03-19,Thomasville,Nevada,29634,950,950,0,9/3/2021 18:13,1/12/2022 18:44
5355,1951-09-08,Thomasville,New Hampshire,29634,1200,1200,0,9/3/2021 18:14,3/19/2022 15:24
5356,1968-08-15,Thomasville,New Jersey,29634,1350,1350,0,9/3/2021 18:15,3/2/2022 21:16
5357,1976-08-10,Thomasville,New Mexico,29634,1050,1550,500,9/3/2021 18:16,3/16/2022 19:14
5358,1997-12-11,Thomasville,New York,29634,1550,1550,0,9/3/2021 18:16,3/29/2022 16:02
5359,2003-03-22,Palm Beach Gardens,Florida,33410,400,400,0,9/3/2021 18:16,2/26/2022 18:35
5360,1985-12-19,Thomasville,North Carolina,29634,650,650,0,9/3/2021 18:16,1/30/2022 23:51
5361,1972-09-23,Thomasville,North Dakota,29634,1550,1550,0,9/3/2021 18:16,2/26/2022 19:14
5362,1970-09-06,Thomasville,Ohio,29634,310,310,0,9/3/2021 18:18,6/8/2022 8:09
5363,1950-01-19,Thomasville,Oklahoma,29634,2090,2090,0,9/3/2021 18:18,4/18/2022 13:57
5364,1996-02-11,Thomasville,Oregon,29634,300,300,0,9/3/2021 18:18,12/1/2021 16:40
5365,1989-03-23,Thomasville,Pennsylvania,29634,3420,3420,0,9/3/2021 18:18,6/30/2022 13:20
5366,1985-01-09,Thomasville,Rhode Island,29634,650,650,0,9/3/2021 18:19,3/13/2022 23:19
5367,1999-04-24,Thomasville,South Carolina,29634,1300,1300,0,9/3/2021 18:20,3/16/2022 15:07
5368,1951-06-24,Thomasville,South Dakota,29634,2130,2130,0,9/3/2021 18:20,2/9/2022 11:15
5369,1972-04-23,Thomasville,Tennessee,29634,300,300,0,9/3/2021 18:20,1/12/2022 16:55
5370,1991-11-12,Thomasville,Texas,29634,430,430,0,9/3/2021 18:20,4/6/2022 9:52
5371,1986-04-26,Thomasville,Utah,29634,1910,1910,0,9/3/2021 18:20,4/8/2022 19:00
5372,1983-12-28,Thomasville,Vermont,29634,300,300,0,9/3/2021 18:21,3/19/2022 15:36
5373,1994-05-23,Thomasville,Virginia,29634,6520,6520,0,9/3/2021 18:22,5/26/2022 20:07
5374,1979-02-06,Thomasville,Washington,29634,500,500,0,9/3/2021 18:22,3/19/2022 9:39
5375,1979-03-25,Thomasville,West Virginia,29634,3280,3280,0,9/3/2021 18:22,4/25/2022 14:19
5376,1958-11-22,Thomasville,Wisconsin,29634,710,710,0,9/3/2021 18:22,5/17/2022 21:57
5377,1991-06-10,Thomasville,Wyoming,29634,970,970,0,9/3/2021 18:22,5/7/2022 12:12
5378,1961-07-08,Thomasville,Alabama,29634,300,300,0,9/3/2021 18:22,11/13/2021 17:04
5379,1988-04-08,Thomasville,Alaska,29634,300,300,0,9/3/2021 18:23,1/22/2022 18:36
5380,1984-12-24,Thomasville,Arizona,29634,600,600,0,9/3/2021 18:23,3/18/2022 16:01
5381,1984-04-22,Thomasville,Arkansas,29634,300,300,0,9/3/2021 18:23,1/21/2022 21:35
5382,1995-07-17,Thomasville,California,29634,1000,1000,0,9/3/2021 18:23,3/1/2022 16:06
5383,1970-11-25,Thomasville,Colorado,29634,750,750,0,9/3/2021 18:23,2/9/2022 15:37
5384,2000-04-25,Thomasville,Connecticut,29634,300,300,0,9/3/2021 18:23,3/25/2022 16:33
5385,1986-03-11,Thomasville,Delaware,29634,350,350,0,9/3/2021 18:24,1/19/2022 0:08
5386,1955-02-10,Thomasville,District of Columbia,29634,50,550,500,9/3/2021 18:26,2/19/2022 12:35
5387,1962-08-26,Thomasville,Florida,29634,350,350,0,9/3/2021 18:26,9/3/2021 18:27
5388,1956-07-09,Thomasville,Georgia,29634,300,300,0,9/3/2021 18:26,9/3/2021 19:09
5389,1983-01-03,Thomasville,Hawaii,29634,300,300,0,9/3/2021 18:27,9/3/2021 19:52
5390,2001-02-08,Thomasville,Idaho,29634,350,350,0,9/3/2021 18:27,9/18/2021 14:22
5391,1962-12-12,Thomasville,Illinois,29634,300,300,0,9/3/2021 18:28,1/21/2022 0:18
5392,1950-05-04,Thomasville,Indiana,29634,750,750,0,9/3/2021 18:28,2/22/2022 9:58
5393,1951-10-06,Thomasville,Iowa,29634,1200,1200,0,9/3/2021 18:29,3/7/2022 11:05
5394,1997-07-22,Thomasville,Kansas,29634,0,500,500,9/3/2021 18:29,3/17/2022 20:19
5395,2000-04-26,Thomasville,Kentucky,29634,610,610,0,9/3/2021 18:29,5/13/2022 18:23
5396,1958-01-02,Thomasville,Louisiana,29634,420,420,0,9/3/2021 18:30,5/22/2022 12:10
5397,1988-12-31,Thomasville,Maine,29634,450,450,0,9/3/2021 18:30,1/26/2022 15:03
5398,1957-06-08,Thomasville,Maryland,29634,300,300,0,9/3/2021 18:30,10/19/2021 20:03
5399,1976-04-11,Thomasville,Massachusetts,29634,400,400,0,9/3/2021 18:30,11/13/2021 19:38
5400,1977-06-25,Thomasville,Michigan,29634,600,600,0,9/3/2021 18:31,3/2/2022 15:09
5401,1993-10-13,Thomasville,Minnesota,29634,4620,4620,0,9/3/2021 18:31,4/30/2022 18:20
5402,1966-03-04,Thomasville,Mississippi,29634,300,300,0,9/3/2021 18:32,3/19/2022 16:09
5403,2003-08-12,Thomasville,Missouri,29634,1100,1100,0,9/3/2021 18:32,1/22/2022 18:56
5404,1960-01-25,Thomasville,Montana,29634,750,750,0,9/3/2021 18:32,1/12/2022 19:23
5405,2005-09-06,Thomasville,Nebraska,29634,6800,6800,0,9/3/2021 18:33,4/6/2022 22:45
5406,1995-10-16,Thomasville,Nevada,29634,300,300,0,9/3/2021 18:33,9/3/2021 20:04
5407,1984-01-18,Thomasville,New Hampshire,29634,820,820,0,9/3/2021 18:33,4/18/2022 18:01
5408,1999-11-05,Thomasville,New Jersey,29634,350,350,0,9/3/2021 18:33,1/17/2022 15:20
5409,1978-04-13,Thomasville,New Mexico,29634,300,300,0,9/3/2021 18:33,1/22/2022 18:22
5410,1952-11-17,Thomasville,New York,29634,1160,1160,0,9/3/2021 18:34,5/3/2022 18:31
5411,1972-06-06,Thomasville,North Carolina,29634,350,350,0,9/3/2021 18:34,10/30/2021 15:49
5412,1978-02-23,Thomasville,North Dakota,29634,350,350,0,9/3/2021 18:34,1/12/2022 17:43
5413,1994-10-02,Thomasville,Ohio,29634,450,450,0,9/3/2021 18:34,3/2/2022 12:58
5414,1963-07-15,Thomasville,Oklahoma,29634,300,300,0,9/3/2021 18:35,2/22/2022 9:55
5415,1986-04-19,Thomasville,Oregon,29634,510,510,0,9/3/2021 18:35,4/23/2022 16:02
5416,1994-09-26,Thomasville,Pennsylvania,29634,350,350,0,9/3/2021 18:35,1/19/2022 16:41
5417,1995-08-19,Thomasville,Rhode Island,29634,450,450,0,9/3/2021 18:35,1/12/2022 16:32
5418,2004-06-25,Thomasville,South Carolina,29634,950,950,0,9/3/2021 18:36,1/22/2022 18:51
5419,1999-06-04,Thomasville,South Dakota,29634,350,350,0,9/3/2021 18:36,9/3/2021 19:05
5420,1990-02-20,Thomasville,Tennessee,29634,460,460,0,9/3/2021 18:36,4/16/2022 14:43
5421,1996-08-12,Thomasville,Texas,29634,300,300,0,9/3/2021 18:37,2/26/2022 18:54
5422,1997-06-23,Thomasville,Utah,29634,810,810,0,9/3/2021 18:37,4/18/2022 19:23
5423,1950-06-25,Thomasville,Vermont,29634,630,630,0,9/3/2021 18:37,6/14/2022 18:56
5424,1959-11-09,Thomasville,Virginia,29634,400,400,0,9/3/2021 18:38,3/2/2022 16:57
5425,2000-12-08,Thomasville,Washington,29634,400,400,0,9/3/2021 18:38,11/13/2021 11:46
5426,1966-05-12,Thomasville,West Virginia,29634,470,470,0,9/3/2021 18:38,5/12/2022 18:52
5427,1977-08-04,Thomasville,Wisconsin,29634,1220,1220,0,9/3/2021 18:38,4/8/2022 21:52
5428,2001-04-14,Thomasville,Wyoming,29634,800,800,0,9/3/2021 18:39,2/3/2022 12:11
5429,2002-04-27,Thomasville,Alabama,29634,750,750,0,9/3/2021 18:39,3/30/2022 11:12
5430,1980-02-21,Thomasville,Alaska,29634,700,700,0,9/3/2021 18:40,3/25/2022 10:25
5431,1987-04-25,Thomasville,Arizona,29634,730,730,0,9/3/2021 18:40,6/25/2022 23:46
5432,1977-06-08,Thomasville,Arkansas,29634,2020,2020,0,9/3/2021 18:40,4/15/2022 10:14
5433,1963-01-25,Thomasville,California,29634,310,310,0,9/3/2021 18:40,4/15/2022 21:15
5434,2003-08-24,Thomasville,Colorado,29634,1300,1300,0,9/3/2021 18:40,3/5/2022 17:33
5435,1986-05-03,Thomasville,Connecticut,29634,600,600,0,9/3/2021 18:40,2/26/2022 13:46
5436,2000-07-03,Thomasville,Delaware,29634,300,800,500,9/3/2021 18:41,3/1/2022 11:52
5437,2005-06-10,Thomasville,District of Columbia,29634,350,350,0,9/3/2021 18:43,3/29/2022 19:03
5438,1987-01-04,Thomasville,Florida,29634,3400,3400,0,9/3/2021 18:43,4/8/2022 19:05
5439,2002-11-28,Thomasville,Georgia,29634,300,300,0,9/3/2021 18:43,12/1/2021 10:51
5440,2001-03-10,Thomasville,Hawaii,29634,320,320,0,9/3/2021 18:44,6/23/2022 17:41
5441,1968-02-12,Thomasville,Idaho,29634,2180,2680,500,9/3/2021 18:44,6/15/2022 16:50
5442,1954-10-16,Thomasville,Illinois,29634,700,700,0,9/3/2021 18:44,12/31/2021 18:31
5443,1956-11-27,Thomasville,Indiana,29634,350,350,0,9/3/2021 18:44,1/22/2022 13:06
5444,1973-10-11,Thomasville,Iowa,29634,550,550,0,9/3/2021 18:44,1/23/2022 16:01
5445,1999-10-05,Thomasville,Kansas,29634,1860,1860,0,9/3/2021 18:45,5/3/2022 19:06
5446,1969-03-09,Thomasville,Kentucky,29634,350,350,0,9/3/2021 18:46,10/30/2021 13:15
5447,1970-06-14,Thomasville,Louisiana,29634,1000,1000,0,9/3/2021 18:47,2/26/2022 19:07
5448,1974-05-19,Thomasville,Maine,29634,400,400,0,9/3/2021 18:47,3/13/2022 22:20
5449,1960-08-04,Thomasville,Maryland,29634,1060,1560,500,9/3/2021 18:47,2/15/2022 14:48
5450,1957-08-01,Thomasville,Massachusetts,29634,300,300,0,9/3/2021 18:48,11/10/2021 20:18
5451,1953-09-14,Thomasville,Michigan,29634,700,1200,500,9/3/2021 18:48,3/16/2022 16:06
5452,2001-12-25,Thomasville,Minnesota,29634,300,300,0,9/3/2021 18:48,3/22/2022 12:45
5453,1975-11-22,Thomasville,Mississippi,29634,660,1160,500,9/3/2021 18:48,2/12/2022 15:45
5454,1959-12-06,Thomasville,Missouri,29634,300,300,0,9/3/2021 18:49,4/5/2022 13:20
5455,1973-10-21,Thomasville,Montana,29634,1450,1450,0,9/3/2021 18:49,11/13/2021 23:05
5456,1957-10-21,Thomasville,Nebraska,29634,1050,1050,0,9/3/2021 18:50,2/28/2022 10:25
5457,1950-10-08,Thomasville,Nevada,29634,1010,1010,0,9/3/2021 18:50,4/8/2022 19:13
5458,1971-11-12,Thomasville,New Hampshire,29634,410,410,0,9/3/2021 18:50,10/1/2021 20:04
5459,2002-05-28,Winston-Salem,North Carolina,27109,4800,4800,0,9/3/2021 18:51,4/13/2022 18:46
5460,1977-06-24,Thomasville,New Jersey,29634,350,350,0,9/3/2021 18:52,2/15/2022 14:56
5461,1989-07-09,Thomasville,New Mexico,29634,360,360,0,9/3/2021 18:52,5/2/2022 10:03
5462,1988-08-03,Thomasville,New York,29634,350,350,0,9/3/2021 18:53,9/8/2021 21:59
5463,1991-03-05,Thomasville,North Carolina,29634,350,350,0,9/3/2021 18:53,9/3/2021 19:14
5464,2001-10-04,Thomasville,North Dakota,29634,300,300,0,9/3/2021 18:53,9/16/2021 23:34
5465,2005-09-14,Thomasville,Ohio,29634,500,500,0,9/3/2021 18:53,1/22/2022 19:40
5466,1979-12-02,Thomasville,Oklahoma,29634,720,720,0,9/3/2021 18:53,4/20/2022 21:11
5467,1977-04-28,Thomasville,Oregon,29634,860,860,0,9/3/2021 18:57,5/3/2022 19:08
5468,1950-06-21,Thomasville,Pennsylvania,29634,350,350,0,9/3/2021 18:59,11/13/2021 22:21
5469,1983-09-15,Thomasville,Rhode Island,29634,1360,1360,0,9/3/2021 19:00,6/10/2022 19:52
5470,1965-08-07,Thomasville,South Carolina,29634,360,360,0,9/3/2021 19:00,6/29/2022 23:13
5471,1975-01-11,Thomasville,South Dakota,29634,1500,1500,0,9/3/2021 19:01,5/7/2022 13:04
5472,2000-11-24,Thomasville,Tennessee,29634,10700,10700,0,9/3/2021 19:02,4/14/2022 19:33
5473,2002-06-08,Thomasville,Texas,29634,300,300,0,9/3/2021 19:04,12/1/2021 14:44
5474,1982-06-07,Thomasville,Utah,29634,940,940,0,9/3/2021 19:04,5/11/2022 17:52
5475,1970-05-05,Thomasville,Vermont,29634,300,300,0,9/3/2021 19:06,1/22/2022 16:46
5476,1989-09-22,Thomasville,Virginia,29634,850,850,0,9/3/2021 19:06,4/6/2022 9:35
5477,1961-03-24,Thomasville,Washington,29634,300,300,0,9/3/2021 19:07,3/15/2022 10:00
5478,2005-08-17,Thomasville,West Virginia,29634,360,360,0,9/3/2021 19:07,4/23/2022 13:48
5479,1955-01-24,Thomasville,Wisconsin,29634,300,300,0,9/3/2021 19:08,1/12/2022 19:08
5480,1970-09-06,Thomasville,Wyoming,29634,6820,6820,0,9/3/2021 19:09,5/11/2022 19:47
5481,1999-09-09,Thomasville,Alabama,29634,300,300,0,9/3/2021 19:09,10/30/2021 16:11
5482,2005-10-07,Thomasville,Alaska,29634,400,400,0,9/3/2021 19:10,2/19/2022 15:14
5483,1958-04-10,Thomasville,Arizona,29634,1130,1130,0,9/3/2021 19:10,6/16/2022 9:29
5484,1962-11-27,Thomasville,Arkansas,29634,1100,1100,0,9/3/2021 19:11,3/31/2022 17:28
5485,1983-08-15,Thomasville,California,29634,700,700,0,9/3/2021 19:11,2/16/2022 14:21
5486,1958-04-14,Thomasville,Colorado,29634,450,450,0,9/3/2021 19:12,10/30/2021 15:33
5487,2001-02-26,Thomasville,Connecticut,29634,450,450,0,9/3/2021 19:12,3/2/2022 21:01
5488,1995-09-26,Thomasville,Delaware,29634,350,350,0,9/3/2021 19:14,3/4/2022 12:24
5489,1960-04-20,Thomasville,District of Columbia,29634,2000,2000,0,9/3/2021 19:18,3/31/2022 19:57
5490,1961-06-10,Thomasville,Florida,29634,350,350,0,9/3/2021 19:19,11/13/2021 20:01
5491,1993-12-22,Thomasville,Georgia,29634,410,410,0,9/3/2021 19:20,6/1/2022 21:08
5492,1991-05-23,Thomasville,Hawaii,29634,1500,1500,0,9/3/2021 19:23,3/2/2022 22:49
5493,2001-04-13,Thomasville,Idaho,29634,2150,2150,0,9/3/2021 19:24,3/19/2022 13:25
5494,1970-09-28,Thomasville,Illinois,29634,750,750,0,9/3/2021 19:24,3/25/2022 10:03
5495,1979-09-23,Thomasville,Indiana,29634,450,450,0,9/3/2021 19:27,11/27/2021 21:28
5496,1951-12-03,Thomasville,Iowa,29634,1770,1770,0,9/3/2021 19:27,4/9/2022 11:34
5497,1989-09-04,Thomasville,Kansas,29634,500,500,0,9/3/2021 19:27,2/27/2022 10:56
5498,1961-06-13,Thomasville,Kentucky,29634,2520,2520,0,9/3/2021 19:27,4/10/2022 18:48
5499,1960-01-25,Thomasville,Louisiana,29634,900,900,0,9/3/2021 19:28,3/2/2022 20:41
5500,1997-04-08,Thomasville,Maine,29634,650,1650,1000,9/3/2021 19:28,2/18/2022 9:00
5501,2000-10-15,Thomasville,Maryland,29634,1510,3510,2000,9/3/2021 19:31,5/17/2022 18:34
5502,1986-09-24,Thomasville,Massachusetts,29634,1700,1700,0,9/3/2021 19:32,3/2/2022 22:47
5503,1974-11-14,Thomasville,Michigan,29634,300,300,0,9/3/2021 19:35,3/19/2022 16:23
5504,1990-12-08,Thomasville,Minnesota,29634,1800,1800,0,9/3/2021 19:39,3/2/2022 20:27
5505,2003-05-07,Thomasville,Mississippi,29634,300,1300,1000,9/3/2021 19:47,3/1/2022 11:53
5506,2005-08-26,Thomasville,Missouri,29634,500,500,0,9/3/2021 19:47,2/26/2022 19:13
5507,1970-12-20,Thomasville,Montana,29634,300,300,0,9/3/2021 19:57,9/3/2021 19:57
5508,1966-06-15,Thomasville,Nebraska,29634,300,300,0,9/3/2021 20:04,11/13/2021 19:12
5509,1981-10-17,Thomasville,Nevada,29634,300,300,0,9/3/2021 20:06,11/14/2021 12:06
5510,1989-09-26,Thomasville,New Hampshire,29634,1850,1850,0,9/3/2021 20:07,3/19/2022 16:18
5511,1971-03-22,Thomasville,New Jersey,29634,350,350,0,9/3/2021 20:07,9/3/2021 20:09
5512,1952-11-01,Thomasville,New Mexico,29634,2150,2150,0,9/3/2021 20:10,2/26/2022 19:06
5513,1982-09-25,Thomasville,New York,29634,380,380,0,9/3/2021 20:23,5/9/2022 18:02
5514,1963-07-30,Thomasville,North Carolina,29634,460,460,0,9/3/2021 20:25,5/1/2022 14:43
5515,2004-05-22,Thomasville,North Dakota,29634,1000,1000,0,9/3/2021 20:28,3/2/2022 20:44
5516,1966-06-01,Thomasville,Ohio,29634,850,850,0,9/3/2021 20:34,3/2/2022 20:49
5517,1976-02-27,Thomasville,Oklahoma,29634,300,300,0,9/3/2021 21:06,3/26/2022 15:29
5518,1958-09-03,Thomasville,Oregon,29634,310,310,0,9/3/2021 21:28,4/15/2022 17:18
5519,1995-01-07,Thomasville,Pennsylvania,29634,400,400,0,9/3/2021 21:46,2/26/2022 19:37
5520,1990-11-15,Thomasville,Rhode Island,29634,1200,1200,0,9/3/2021 21:48,11/30/2021 22:10
5521,1972-04-04,Thomasville,South Carolina,29634,760,760,0,9/3/2021 22:28,3/16/2022 10:38
5522,1995-12-06,Thomasville,South Dakota,29634,300,300,0,9/4/2021 9:17,3/13/2022 22:30
5523,2003-08-25,Thomasville,Tennessee,29634,3040,3040,0,9/4/2021 10:59,2/7/2022 7:00
5524,1985-05-16,Thomasville,Texas,29634,3070,3070,0,9/4/2021 11:56,5/30/2022 2:06
5525,1971-09-17,Thomasville,Utah,29634,2460,2460,0,9/4/2021 12:03,4/21/2022 20:09
5526,1957-04-20,Thomasville,Vermont,29634,310,310,0,9/4/2021 12:46,5/26/2022 21:01
5527,1979-04-22,Thomasville,Virginia,29634,310,310,0,9/4/2021 12:47,4/10/2022 9:27
5528,1971-10-03,Thomasville,Washington,29634,1170,1170,0,9/4/2021 13:05,5/12/2022 18:13
5529,2003-06-26,Winston-Salem,North Carolina,27109,450,450,0,9/4/2021 13:08,10/26/2021 10:55
5530,1961-08-26,Thomasville,West Virginia,29634,260,760,500,9/4/2021 14:36,6/13/2022 18:32
5531,1982-02-25,Thomasville,Wisconsin,29634,850,1350,500,9/4/2021 15:02,11/30/2021 18:40
5532,1999-04-21,Thomasville,Wyoming,29634,1620,1620,0,9/4/2021 15:09,5/11/2022 20:44
5533,1985-05-19,Thomasville,Alabama,29634,300,300,0,9/4/2021 15:23,10/2/2021 11:41
5534,1985-11-12,Thomasville,Alaska,29634,300,300,0,9/4/2021 16:32,9/4/2021 16:33
5535,1978-05-19,Thomasville,Arizona,29634,300,300,0,9/4/2021 16:54,9/4/2021 19:50
5536,2003-03-09,Thomasville,Arkansas,29634,1110,1110,0,9/4/2021 17:03,1/12/2022 20:23
5537,1979-07-22,Thomasville,California,29634,1420,1420,0,9/4/2021 17:11,4/12/2022 13:54
5538,1966-11-14,Thomasville,Colorado,29634,300,300,0,9/4/2021 18:38,9/4/2021 20:20
5539,1978-03-28,Thomasville,Connecticut,29634,510,510,0,9/4/2021 18:41,4/18/2022 10:56
5540,1965-11-20,Thomasville,Delaware,29634,550,550,0,9/4/2021 18:41,9/11/2021 12:48
5541,1983-12-20,Thomasville,District of Columbia,29634,350,350,0,9/4/2021 18:54,11/13/2021 10:00
5542,1986-04-25,Thomasville,Florida,29634,400,400,0,9/4/2021 18:55,10/30/2021 17:39
5543,1995-11-19,Thomasville,Georgia,29634,1270,1270,0,9/4/2021 18:55,4/21/2022 17:57
5544,2003-12-26,Thomasville,Hawaii,29634,350,350,0,9/4/2021 18:59,10/7/2021 17:16
5545,1997-06-06,Thomasville,Idaho,29634,2580,2580,0,9/4/2021 19:05,5/6/2022 12:19
5546,1972-04-16,Thomasville,Illinois,29634,780,780,0,9/4/2021 19:10,5/26/2022 20:06
5547,1994-02-26,Thomasville,Indiana,29634,350,350,0,9/4/2021 19:12,9/4/2021 19:59
5548,2002-08-14,Thomasville,Iowa,29634,350,350,0,9/4/2021 19:14,9/4/2021 22:12
5549,1959-05-02,Thomasville,Kansas,29634,350,350,0,9/4/2021 19:14,10/16/2021 21:22
5550,1967-09-08,Thomasville,Kentucky,29634,650,650,0,9/4/2021 19:16,3/5/2022 14:31
5551,1978-03-11,Thomasville,Louisiana,29634,4650,4650,0,9/4/2021 19:16,5/8/2022 13:22
5552,1960-08-12,Thomasville,Maine,29634,4000,4000,0,9/4/2021 19:16,5/5/2022 19:30
5553,1966-05-23,Thomasville,Maryland,29634,2400,2400,0,9/4/2021 19:22,1/27/2022 6:38
5554,1993-09-19,Thomasville,Massachusetts,29634,400,400,0,9/4/2021 19:23,1/10/2022 15:23
5555,1986-09-27,Thomasville,Michigan,29634,300,300,0,9/4/2021 19:24,9/10/2021 20:29
5556,1992-10-14,Thomasville,Minnesota,29634,1560,1560,0,9/4/2021 19:35,4/8/2022 18:59
5557,1955-06-16,Thomasville,Mississippi,29634,650,650,0,9/4/2021 19:35,3/27/2022 14:21
5558,1961-12-08,Thomasville,Missouri,29634,300,300,0,9/4/2021 19:37,1/22/2022 16:38
5559,2001-08-03,Thomasville,Montana,29634,460,460,0,9/4/2021 19:37,4/21/2022 21:17
5560,1974-07-07,Thomasville,Nebraska,29634,800,800,0,9/4/2021 19:47,3/14/2022 9:00
5561,1970-03-18,Thomasville,Nevada,29634,450,450,0,9/4/2021 19:48,1/20/2022 15:43
5562,2002-01-01,Thomasville,New Hampshire,29634,400,400,0,9/4/2021 19:57,2/23/2022 19:27
5563,1981-09-16,Thomasville,New Jersey,29634,810,810,0,9/4/2021 20:04,1/10/2022 18:03
5564,2000-04-10,Thomasville,New Mexico,29634,1800,1800,0,9/4/2021 20:24,1/12/2022 10:42
5565,2001-11-09,Thomasville,New York,29634,700,700,0,9/5/2021 0:55,3/15/2022 19:00
5566,1973-01-11,Thomasville,North Carolina,29634,910,910,0,9/5/2021 12:28,4/9/2022 14:28
5567,1951-12-27,Thomasville,North Dakota,29634,300,300,0,9/5/2021 13:32,3/2/2022 9:12
5568,2000-02-24,Thomasville,Ohio,29634,650,650,0,9/5/2021 13:36,12/21/2021 1:07
5569,2005-10-24,Thomasville,Oklahoma,29634,300,300,0,9/5/2021 13:36,10/29/2021 20:00
5570,1957-02-05,Thomasville,Oregon,29634,1650,1650,0,9/5/2021 14:09,6/30/2022 14:01
5571,1976-07-13,Thomasville,Pennsylvania,29634,380,380,0,9/5/2021 16:00,6/26/2022 21:05
5572,1987-01-14,Thomasville,Rhode Island,29634,550,550,0,9/6/2021 13:17,3/15/2022 10:22
5573,1967-11-26,Thomasville,South Carolina,29634,1380,1380,0,9/6/2021 14:19,2/21/2022 19:08
5574,1999-11-08,Charlotte,North Carolina,28262,200,200,0,9/6/2021 16:49,9/15/2021 7:18
5575,1993-03-10,Thomasville,South Dakota,29634,510,510,0,9/6/2021 17:56,5/8/2022 10:01
5576,1990-07-20,Thomasville,Tennessee,29634,1070,1070,0,9/6/2021 18:41,4/27/2022 19:40
5577,1952-05-15,Thomasville,Texas,29634,300,300,0,9/6/2021 18:43,1/22/2022 21:38
5578,2002-01-07,Thomasville,Utah,29634,2370,2370,0,9/6/2021 19:25,5/3/2022 19:54
5579,2000-01-11,Thomasville,Vermont,29634,0,300,300,9/6/2021 19:38,3/5/2022 14:30
5580,1997-04-21,Thomasville,Virginia,29634,610,610,0,9/6/2021 21:22,5/11/2022 18:13
5581,2000-02-15,Thomasville,Washington,29634,300,300,0,9/6/2021 22:36,3/19/2022 14:45
5582,1982-07-17,Thomasville,West Virginia,29634,300,300,0,9/7/2021 9:06,2/9/2022 10:18
5583,2001-05-28,Thomasville,Wisconsin,29634,200,200,0,9/7/2021 11:03,3/23/2022 13:05
5584,1998-05-18,Winston-Salem,North Carolina,27103,400,400,0,9/7/2021 11:18,12/9/2021 10:27
5585,1998-07-30,Thomasville,Wyoming,29634,400,400,0,9/7/2021 11:57,9/7/2021 12:03
5586,1959-12-18,Thomasville,Alabama,29634,300,300,0,9/7/2021 13:28,4/3/2022 13:20
5587,1973-01-15,Thomasville,Alaska,29634,950,950,0,9/7/2021 13:54,1/22/2022 20:45
5588,1984-02-09,Thomasville,Arizona,29634,300,300,0,9/7/2021 15:08,1/22/2022 19:24
5589,1971-11-21,Thomasville,Arkansas,29634,300,300,0,9/7/2021 15:15,3/15/2022 16:39
5590,2003-06-03,Thomasville,California,29634,400,400,0,9/7/2021 15:43,3/15/2022 19:50
5591,2005-12-21,Thomasville,Colorado,29634,300,300,0,9/7/2021 17:08,2/24/2022 13:44
5592,1973-01-09,Thomasville,Connecticut,29634,400,400,0,9/7/2021 19:25,1/11/2022 19:34
5593,1973-02-18,Thomasville,Delaware,29634,300,300,0,9/7/2021 20:27,1/18/2022 22:06
5594,1982-06-05,Thomasville,District of Columbia,29634,1150,1150,0,9/7/2021 22:21,3/2/2022 20:34
5595,2003-09-06,Thomasville,Florida,29634,660,660,0,9/8/2021 11:03,1/29/2022 16:36
5596,1994-03-05,Thomasville,Georgia,29634,770,770,0,9/8/2021 11:44,4/7/2022 18:00
5597,1996-08-04,Thomasville,Hawaii,29634,650,650,0,9/8/2021 12:55,11/14/2021 13:56
5598,1970-06-21,Thomasville,Idaho,29634,600,600,0,9/8/2021 14:02,2/19/2022 13:13
5599,1952-01-03,Thomasville,Illinois,29634,2980,2980,0,9/8/2021 16:12,5/14/2022 8:32
5600,1977-07-09,Thomasville,Indiana,29634,1150,1150,0,9/8/2021 19:33,12/6/2021 18:13
5601,1984-12-06,Thomasville,Iowa,29634,300,300,0,9/8/2021 20:05,11/30/2021 16:21
5602,1990-08-07,Thomasville,Kansas,29634,620,620,0,9/8/2021 23:08,6/26/2022 20:03
5603,1991-10-04,Thomasville,Kentucky,29634,650,650,0,9/9/2021 9:33,11/20/2021 11:59
5604,1974-08-05,Thomasville,Louisiana,29634,1210,1210,0,9/9/2021 11:00,2/26/2022 20:00
5605,1968-10-16,Thomasville,Maine,29634,750,750,0,9/9/2021 11:23,3/9/2022 23:21
5606,1954-08-26,Thomasville,Maryland,29634,300,300,0,9/9/2021 12:32,1/12/2022 12:59
5607,1983-10-15,Thomasville,Massachusetts,29634,420,420,0,9/9/2021 12:57,4/10/2022 7:56
5608,1991-08-28,Thomasville,Michigan,29634,300,300,0,9/9/2021 14:38,9/13/2021 20:15
5609,2002-01-17,Thomasville,Minnesota,29634,300,300,0,9/9/2021 17:25,9/11/2021 13:32
5610,1953-10-09,Thomasville,Mississippi,29634,450,450,0,9/9/2021 17:34,2/20/2022 16:06
5611,1976-11-12,Thomasville,Missouri,29634,300,300,0,9/9/2021 18:29,1/10/2022 18:58
5612,1994-04-06,Thomasville,Montana,29634,1000,1000,0,9/9/2021 18:36,3/2/2022 20:24
5613,1977-04-12,Thomasville,Nebraska,29634,770,770,0,9/9/2021 18:46,4/19/2022 18:48
5614,1978-04-11,Thomasville,Nevada,29634,800,800,0,9/9/2021 18:58,2/16/2022 10:56
5615,1973-03-24,Thomasville,New Hampshire,29634,300,300,0,9/9/2021 18:59,9/9/2021 19:00
5616,1973-04-13,Thomasville,New Jersey,29634,660,660,0,9/9/2021 19:07,4/19/2022 19:01
5617,1989-12-07,Thomasville,New Mexico,29634,470,470,0,9/9/2021 19:08,4/20/2022 10:36
5618,2001-05-03,Thomasville,New York,29634,460,460,0,9/9/2021 19:08,4/17/2022 11:46
5619,1961-03-06,Thomasville,North Carolina,29634,650,650,0,9/9/2021 19:12,11/19/2021 13:46
5620,1990-07-03,Thomasville,North Dakota,29634,600,600,0,9/9/2021 19:16,2/10/2022 13:44
5621,1998-06-28,Thomasville,Ohio,29634,2880,2880,0,9/9/2021 19:33,5/3/2022 18:28
5622,1956-08-03,Thomasville,Oklahoma,29634,300,300,0,9/9/2021 19:48,9/18/2021 16:51
5623,2004-02-18,Thomasville,Oregon,29634,1100,1100,0,9/9/2021 19:49,5/14/2022 17:04
5624,2001-01-08,Thomasville,Pennsylvania,29634,1770,1770,0,9/9/2021 19:57,2/12/2022 14:08
5625,1977-01-13,Thomasville,Rhode Island,29634,500,500,0,9/9/2021 19:58,1/22/2022 20:19
5626,1997-06-02,Thomasville,South Carolina,29634,790,790,0,9/9/2021 20:02,4/18/2022 9:57
5627,2004-04-01,Thomasville,South Dakota,29634,300,300,0,9/9/2021 20:18,9/11/2021 16:27
5628,1958-03-27,Thomasville,Tennessee,29634,50,1050,1000,9/9/2021 22:00,2/18/2022 10:23
5629,1951-10-01,Thomasville,Texas,29634,410,410,0,9/9/2021 22:26,5/9/2022 18:49
5630,1965-01-04,Thomasville,Utah,29634,1150,1150,0,9/9/2021 23:09,3/16/2022 19:10
5631,1998-02-12,Thomasville,Vermont,29634,450,450,0,9/10/2021 10:55,1/19/2022 22:23
5632,1982-12-25,Thomasville,Virginia,29634,500,500,0,9/10/2021 11:10,3/22/2022 9:57
5633,1977-04-09,Thomasville,Washington,29634,1110,1110,0,9/10/2021 13:00,4/15/2022 14:05
5634,1989-12-28,Thomasville,West Virginia,29634,1780,1780,0,9/10/2021 13:52,5/11/2022 18:00
5635,1992-08-02,Winston-Salem,North Carolina,27109,760,1260,500,9/10/2021 14:12,3/15/2022 19:02
5636,1966-08-18,Thomasville,Wisconsin,29634,1360,2360,1000,9/10/2021 14:13,4/27/2022 9:37
5637,1976-03-11,Thomasville,Wyoming,29634,1400,1400,0,9/10/2021 14:56,4/4/2022 21:13
5638,1999-05-20,Thomasville,Alabama,29634,1710,1710,0,9/10/2021 14:57,2/8/2022 18:44
5639,1967-08-20,Thomasville,Alaska,29634,100,1100,1000,9/10/2021 15:00,3/17/2022 12:02
5640,1989-03-14,Thomasville,Arizona,29634,2260,2260,0,9/10/2021 15:43,4/12/2022 16:40
5641,1998-12-28,Thomasville,Arkansas,29634,1830,1830,0,9/10/2021 16:20,4/10/2022 23:18
5642,1967-04-22,Thomasville,California,29634,950,950,0,9/10/2021 16:24,2/25/2022 17:57
5643,1986-02-28,Thomasville,Colorado,29634,800,800,0,9/10/2021 16:31,3/2/2022 21:18
5644,1984-02-03,Thomasville,Connecticut,29634,1700,600,0,9/10/2021 16:49,3/2/2022 9:01
5645,1999-08-07,Thomasville,Delaware,29634,650,650,0,9/10/2021 17:01,1/11/2022 19:11
5646,1964-05-09,Thomasville,District of Columbia,29634,600,600,0,9/10/2021 17:38,1/22/2022 19:53
5647,1990-06-03,Thomasville,Florida,29634,300,300,0,9/10/2021 17:38,11/13/2021 17:48
5648,1967-10-27,Thomasville,Georgia,29634,700,700,0,9/10/2021 18:43,3/11/2022 12:51
5649,1967-02-11,Thomasville,Hawaii,29634,300,300,0,9/10/2021 19:42,12/22/2021 0:29
5650,2001-07-29,Thomasville,Idaho,29634,3060,3060,0,9/10/2021 20:31,3/24/2022 18:03
5651,1977-03-24,Thomasville,Illinois,29634,450,450,0,9/10/2021 20:40,12/1/2021 10:53
5652,1986-10-28,Thomasville,Indiana,29634,470,470,0,9/10/2021 20:49,5/30/2022 11:40
5653,1975-06-20,Thomasville,Iowa,29634,510,510,0,9/10/2021 20:57,5/3/2022 14:11
5654,1993-04-19,Thomasville,Kansas,29634,410,410,0,9/10/2021 20:58,4/7/2022 22:57
5655,2001-07-27,Thomasville,Kentucky,29634,1650,2650,1000,9/10/2021 21:05,3/16/2022 19:11
5656,1957-07-16,Thomasville,Louisiana,29634,300,300,0,9/10/2021 21:28,3/7/2022 22:30
5657,1999-04-26,Thomasville,Maine,29634,1470,1470,0,9/10/2021 21:36,5/6/2022 12:13
5658,1994-03-07,Thomasville,Maryland,29634,510,510,0,9/10/2021 21:57,4/9/2022 14:14
5659,1972-02-19,Thomasville,Massachusetts,29634,350,350,0,9/10/2021 23:10,1/18/2022 21:01
5660,1999-04-13,Thomasville,Michigan,29634,400,400,0,9/10/2021 23:52,10/2/2021 10:07
5661,1985-01-15,Thomasville,Minnesota,29634,700,700,0,9/10/2021 23:52,1/12/2022 18:23
5662,1973-03-07,Thomasville,Mississippi,29634,300,300,0,9/11/2021 1:05,2/18/2022 23:47
5663,1965-10-19,Thomasville,Missouri,29634,320,320,0,9/11/2021 1:20,4/9/2022 10:15
5664,1965-02-21,Thomasville,Montana,29634,600,600,0,9/11/2021 3:08,1/22/2022 13:41
5665,2004-10-21,Thomasville,Nebraska,29634,500,500,0,9/11/2021 7:37,3/19/2022 10:02
5666,1961-05-18,Thomasville,Nevada,29634,360,360,0,9/11/2021 8:51,5/5/2022 22:35
5667,1972-05-25,Thomasville,New Hampshire,29634,1010,1010,0,9/11/2021 9:10,4/19/2022 18:13
5668,1987-09-16,Thomasville,New Jersey,29634,350,350,0,9/11/2021 9:15,1/17/2022 11:17
5669,1968-11-12,Thomasville,New Mexico,29634,1600,1600,0,9/11/2021 9:33,3/25/2022 18:56
5670,1970-12-27,Thomasville,New York,29634,600,600,0,9/11/2021 9:34,2/8/2022 17:49
5671,1962-07-23,Thomasville,North Carolina,29634,650,650,0,9/11/2021 9:36,2/25/2022 21:47
5672,2005-05-09,Thomasville,North Dakota,29634,300,300,0,9/11/2021 9:44,3/2/2022 20:08
5673,1994-07-18,Thomasville,Ohio,29634,800,800,0,9/11/2021 9:54,1/27/2022 23:58
5674,1960-09-06,Thomasville,Oklahoma,29634,550,550,0,9/11/2021 10:13,2/19/2022 12:43
5675,1977-03-09,Thomasville,Oregon,29634,1820,1820,0,9/11/2021 10:14,5/3/2022 18:00
5676,2004-12-20,Thomasville,Pennsylvania,29634,550,550,0,9/11/2021 10:20,3/2/2022 19:53
5677,1955-09-01,Thomasville,Rhode Island,29634,510,510,0,9/11/2021 10:21,5/12/2022 11:19
5678,1970-10-09,Thomasville,South Carolina,29634,1480,1480,0,9/11/2021 10:24,4/19/2022 14:23
5679,1985-03-13,Thomasville,South Dakota,29634,1120,1120,0,9/11/2021 10:24,4/29/2022 17:13
5680,1957-03-12,Thomasville,Tennessee,29634,1710,1710,0,9/11/2021 10:24,4/16/2022 12:56
5681,1977-02-07,Thomasville,Texas,29634,1500,2000,500,9/11/2021 10:24,3/17/2022 16:24
5682,1951-09-17,Thomasville,Utah,29634,860,860,0,9/11/2021 10:27,4/13/2022 23:07
5683,1982-02-02,Thomasville,Vermont,29634,750,750,0,9/11/2021 10:29,1/22/2022 19:43
5684,2001-08-25,Thomasville,Virginia,29634,350,350,0,9/11/2021 10:30,11/13/2021 18:49
5685,1983-12-05,Thomasville,Washington,29634,710,710,0,9/11/2021 10:30,4/16/2022 16:40
5686,2002-09-15,Thomasville,West Virginia,29634,310,310,0,9/11/2021 10:32,4/16/2022 16:48
5687,1989-01-07,Thomasville,Wisconsin,29634,1410,1410,0,9/11/2021 10:34,4/19/2022 21:06
5688,1958-03-11,Thomasville,Wyoming,29634,300,300,0,9/11/2021 10:35,3/27/2022 14:14
5689,1951-05-25,Thomasville,Alabama,29634,350,350,0,9/11/2021 10:39,1/12/2022 18:25
5690,2003-04-27,Thomasville,Alaska,29634,300,300,0,9/11/2021 10:42,2/26/2022 18:18
5691,2005-06-23,Thomasville,Arizona,29634,320,320,0,9/11/2021 10:42,5/3/2022 18:03
5692,1972-12-25,Thomasville,Arkansas,29634,400,400,0,9/11/2021 10:42,4/6/2022 20:46
5693,1953-02-15,Thomasville,California,29634,1050,1050,0,9/11/2021 10:44,2/26/2022 18:37
5694,1957-07-15,Thomasville,Colorado,29634,670,670,0,9/11/2021 10:45,5/4/2022 9:01
5695,1974-05-23,Thomasville,Connecticut,29634,2210,2210,0,9/11/2021 10:45,5/11/2022 18:54
5696,1965-09-13,Thomasville,Delaware,29634,300,300,0,9/11/2021 10:49,1/12/2022 16:10
5697,1953-12-14,Thomasville,District of Columbia,29634,3350,3350,0,9/11/2021 10:53,5/11/2022 20:29
5698,1990-10-11,Thomasville,Florida,29634,400,400,0,9/11/2021 10:54,2/26/2022 18:39
5699,1986-04-11,Thomasville,Georgia,29634,350,350,0,9/11/2021 11:09,1/22/2022 19:14
5700,1969-07-11,Thomasville,Hawaii,29634,300,300,0,9/11/2021 11:09,1/22/2022 1:12
5701,1978-04-01,Thomasville,Idaho,29634,750,750,0,9/11/2021 11:12,3/2/2022 21:16
5702,1979-02-15,Thomasville,Illinois,29634,1500,1500,0,9/11/2021 11:14,3/7/2022 18:43
5703,1953-12-27,Thomasville,Indiana,29634,300,300,0,9/11/2021 11:14,1/22/2022 13:30
5704,1960-05-06,Thomasville,Iowa,29634,1210,1210,0,9/11/2021 11:15,3/4/2022 16:40
5705,1996-11-07,Thomasville,Kansas,29634,500,500,0,9/11/2021 11:19,3/8/2022 14:15
5706,1952-03-18,Thomasville,Kentucky,29634,400,400,0,9/11/2021 11:20,2/23/2022 10:00
5707,1968-04-01,Thomasville,Louisiana,29634,400,400,0,9/11/2021 11:20,3/2/2022 9:16
5708,1988-08-23,Thomasville,Maine,29634,500,500,0,9/11/2021 11:24,2/18/2022 20:50
5709,1986-12-02,Thomasville,Maryland,29634,950,950,0,9/11/2021 11:26,1/22/2022 12:18
5710,1960-10-16,Thomasville,Massachusetts,29634,1000,1000,0,9/11/2021 11:27,1/12/2022 17:52
5711,1985-11-19,Thomasville,Michigan,29634,400,400,0,9/11/2021 11:41,1/22/2022 13:19
5712,1991-09-03,Thomasville,Minnesota,29634,310,310,0,9/11/2021 11:41,5/28/2022 17:17
5713,1953-12-25,Thomasville,Mississippi,29634,860,860,0,9/11/2021 11:42,5/2/2022 10:01
5714,1976-03-20,Thomasville,Missouri,29634,300,300,0,9/11/2021 11:44,10/2/2021 12:41
5715,2003-01-18,Thomasville,Montana,29634,1000,1000,0,9/11/2021 11:52,4/20/2022 17:21
5716,1965-05-18,Thomasville,Nebraska,29634,350,350,0,9/11/2021 11:57,2/11/2022 16:29
5717,1978-11-28,Thomasville,Nevada,29634,300,800,500,9/11/2021 12:14,3/2/2022 21:20
5718,1985-10-10,Thomasville,New Hampshire,29634,300,300,0,9/11/2021 12:14,10/13/2021 15:00
5719,1980-09-01,Thomasville,New Jersey,29634,1150,1650,500,9/11/2021 12:39,2/26/2022 19:21
5720,2004-04-04,Thomasville,New Mexico,29634,560,560,0,9/11/2021 13:08,11/29/2021 19:00
5721,1984-01-10,Thomasville,New York,29634,300,300,0,9/11/2021 13:11,3/30/2022 11:15
5722,1996-01-23,Thomasville,North Carolina,29634,450,450,0,9/11/2021 13:50,11/30/2021 15:07
5723,1994-04-13,Thomasville,North Dakota,29634,550,550,0,9/11/2021 14:48,9/16/2021 12:47
5724,1959-05-26,Thomasville,Ohio,29634,300,300,0,9/11/2021 15:47,9/11/2021 15:49
5725,2002-04-06,Thomasville,Oklahoma,29634,1100,1100,0,9/11/2021 15:52,2/3/2022 17:47
5726,1976-06-05,Thomasville,Oregon,29634,300,300,0,9/11/2021 16:00,11/30/2021 12:03
5727,1956-11-13,Thomasville,Pennsylvania,29634,2750,2750,0,9/11/2021 20:42,4/2/2022 16:51
5728,1987-04-02,Thomasville,Rhode Island,29634,950,950,0,9/11/2021 23:43,3/8/2022 14:12
5729,2002-09-21,Thomasville,South Carolina,29634,700,700,0,9/12/2021 12:01,2/17/2022 13:09
5730,1973-04-16,Thomasville,South Dakota,29634,300,300,0,9/12/2021 13:26,1/18/2022 18:42
5731,1969-12-22,Thomasville,Tennessee,29634,660,660,0,9/12/2021 15:34,6/25/2022 21:42
5732,1954-08-14,Thomasville,Texas,29634,300,300,0,9/12/2021 16:35,12/4/2021 18:26
5733,1975-05-06,Thomasville,Utah,29634,300,300,0,9/12/2021 17:30,1/22/2022 16:40
5734,1997-09-04,Thomasville,Vermont,29634,400,400,0,9/13/2021 9:46,3/19/2022 15:34
5735,1952-06-09,Thomasville,Virginia,29634,300,300,0,9/13/2021 9:49,11/13/2021 16:44
5736,1995-07-06,Thomasville,Washington,29634,2570,2570,0,9/13/2021 10:11,5/14/2022 11:13
5737,1957-01-25,Thomasville,West Virginia,29634,350,350,0,9/13/2021 10:11,9/27/2021 19:14
5738,1981-12-26,Thomasville,Wisconsin,29634,320,320,0,9/13/2021 10:48,5/10/2022 9:35
5739,1986-11-03,Thomasville,Wyoming,29634,1000,1000,0,9/13/2021 13:21,1/22/2022 12:08
5740,1997-06-15,Thomasville,Alabama,29634,400,400,0,9/13/2021 13:55,11/5/2021 10:39
5741,1983-05-06,Thomasville,Alaska,29634,300,300,0,9/13/2021 14:03,3/2/2022 20:34
5742,1976-06-05,Thomasville,Arizona,29634,350,350,0,9/13/2021 14:10,11/13/2021 19:11
5743,2002-06-24,Thomasville,Arkansas,29634,500,500,0,9/13/2021 14:15,1/22/2022 17:36
5744,1997-01-12,Thomasville,California,29634,2020,2020,0,9/13/2021 14:59,4/30/2022 11:48
5745,1965-12-07,Thomasville,Colorado,29634,350,350,0,9/13/2021 15:04,1/22/2022 18:27
5746,2001-02-28,Thomasville,Connecticut,29634,300,300,0,9/13/2021 15:29,10/22/2021 23:18
5747,1962-03-16,Thomasville,Delaware,29634,600,600,0,9/13/2021 15:36,1/12/2022 19:10
5748,1950-06-10,Thomasville,District of Columbia,29634,300,300,0,9/13/2021 15:38,9/18/2021 16:23
5749,1993-09-08,Thomasville,Florida,29634,300,300,0,9/13/2021 17:07,3/7/2022 18:00
5750,1975-04-11,Thomasville,Georgia,29634,370,370,0,9/13/2021 17:39,5/20/2022 19:49
5751,1965-02-04,Thomasville,Hawaii,29634,300,300,0,9/13/2021 18:35,10/17/2021 11:20
5752,1957-08-25,Thomasville,Idaho,29634,300,300,0,9/13/2021 19:46,10/17/2021 16:43
5753,1982-10-17,Thomasville,Illinois,29634,360,360,0,9/13/2021 20:11,4/28/2022 17:20
5754,1995-05-03,Thomasville,Indiana,29634,400,400,0,9/13/2021 21:02,9/18/2021 18:40
5755,1998-05-28,Thomasville,Iowa,29634,300,300,0,9/13/2021 22:07,9/18/2021 20:49
5756,1980-10-23,Thomasville,Kansas,29634,300,300,0,9/13/2021 23:59,11/8/2021 11:09
5757,2003-11-18,Thomasville,Kentucky,29634,380,380,0,9/14/2021 8:55,5/4/2022 9:19
5758,2020-02-13,Thomasville,Louisiana,29634,550,550,0,9/14/2021 10:52,3/15/2022 11:46
5759,1998-02-06,Thomasville,Maine,29634,850,850,0,9/14/2021 10:56,12/1/2021 21:18
5760,1958-05-04,Thomasville,Maryland,29634,300,300,0,9/14/2021 12:26,2/20/2022 16:00
5761,2005-10-08,Thomasville,Massachusetts,29634,350,350,0,9/14/2021 13:48,2/10/2022 10:45
5762,1966-04-06,Thomasville,Michigan,29634,300,300,0,9/14/2021 14:35,3/13/2022 22:16
5763,1972-02-06,Thomasville,Minnesota,29634,300,300,0,9/14/2021 15:25,2/19/2022 13:14
5764,1994-05-09,Thomasville,Mississippi,29634,3010,3010,0,9/14/2021 15:26,5/2/2022 22:02
5765,2004-12-05,Thomasville,Missouri,29634,300,300,0,9/14/2021 15:28,3/22/2022 10:09
5766,1999-12-25,Thomasville,Montana,29634,850,850,0,9/14/2021 16:01,2/23/2022 21:10
5767,1956-04-15,Thomasville,Nebraska,29634,750,750,0,9/14/2021 16:08,3/17/2022 9:11
5768,1967-05-06,Thomasville,Nevada,29634,300,300,0,9/14/2021 16:10,9/14/2021 16:12
5769,1981-02-07,Thomasville,New Hampshire,29634,2760,2760,0,9/14/2021 16:54,5/8/2022 20:06
5770,1979-07-22,Thomasville,New Jersey,29634,1360,1860,500,9/14/2021 17:37,5/28/2022 20:18
5771,1996-07-10,Thomasville,New Mexico,29634,1350,1350,0,9/14/2021 18:00,1/17/2022 9:02
5772,1979-08-17,Thomasville,New York,29634,800,800,0,9/14/2021 18:23,2/26/2022 18:44
5773,1965-09-23,Thomasville,North Carolina,29634,300,300,0,9/14/2021 19:45,9/14/2021 19:48
5774,1959-06-19,Thomasville,North Dakota,29634,300,300,0,9/14/2021 20:23,9/14/2021 20:24
5775,1995-11-15,Thomasville,Ohio,29634,400,400,0,9/14/2021 21:48,3/13/2022 7:06
5776,1993-10-11,Thomasville,Oklahoma,29634,300,300,0,9/14/2021 21:56,12/7/2021 8:25
5777,1992-06-17,Thomasville,Oregon,29634,410,410,0,9/14/2021 22:56,6/20/2022 22:37
5778,1978-12-02,Thomasville,Pennsylvania,29634,400,400,0,9/14/2021 23:40,12/2/2021 23:59
5779,1991-11-12,Thomasville,Rhode Island,29634,910,910,0,9/15/2021 9:43,5/3/2022 13:00
5780,1960-07-03,Thomasville,South Carolina,29634,1500,1500,0,9/15/2021 10:05,4/11/2022 11:32
5781,1997-12-07,Winston-Salem ,North Carolina,27103,2640,2640,0,9/15/2021 11:14,5/4/2022 12:01
5782,1996-08-25,Thomasville,South Dakota,29634,660,660,0,9/15/2021 11:40,5/3/2022 13:01
5783,1956-11-21,Thomasville,Tennessee,29634,4515,4515,0,9/15/2021 13:14,5/26/2022 20:06
5784,1992-04-07,Thomasville,Texas,29634,300,300,0,9/15/2021 14:13,2/26/2022 13:44
5785,1998-02-09,Thomasville,Utah,29634,1060,1060,0,9/15/2021 14:57,5/26/2022 20:56
5786,1960-06-06,Thomasville,Vermont,29634,300,300,0,9/15/2021 17:02,3/24/2022 7:55
5787,1969-01-09,Thomasville,Virginia,29634,700,700,0,9/15/2021 17:19,1/31/2022 17:51
5788,1950-05-16,Thomasville,Washington,29634,300,300,0,9/15/2021 17:19,1/31/2022 17:50
5789,2004-01-05,Thomasville,West Virginia,29634,350,350,0,9/15/2021 20:28,2/18/2022 19:57
5790,1973-09-11,Thomasville,Wisconsin,29634,450,450,0,9/15/2021 20:34,2/26/2022 18:04
5791,2000-06-15,Thomasville,Wyoming,29634,1810,1810,0,9/16/2021 11:06,5/15/2022 18:06
5792,1991-10-24,Thomasville,Alabama,29634,1260,1260,0,9/16/2021 11:08,5/11/2022 18:34
5793,1995-01-06,Thomasville,Alaska,29634,350,350,0,9/16/2021 11:40,9/18/2021 14:15
5794,1998-12-02,Thomasville,Arizona,29634,460,460,0,9/16/2021 12:04,5/28/2022 14:23
5795,1979-01-25,Thomasville,Arkansas,29634,300,300,0,9/16/2021 12:12,9/16/2021 12:13
5796,1998-03-05,Thomasville,California,29634,200,200,0,9/16/2021 12:14,9/27/2021 21:49
5797,1995-07-28,Thomasville,Colorado,29634,400,400,0,9/16/2021 12:21,1/22/2022 15:31
5798,1999-07-30,Thomasville,Connecticut,29634,460,460,0,9/16/2021 12:21,4/8/2022 12:43
5799,1992-11-06,Thomasville,Delaware,29634,300,300,0,9/16/2021 12:25,1/22/2022 19:44
5800,1956-05-03,Thomasville,District of Columbia,29634,400,400,0,9/16/2021 12:35,11/12/2021 10:51
5801,1993-03-01,Thomasville,Florida,29634,300,300,0,9/16/2021 13:11,1/21/2022 19:04
5802,1957-07-23,Thomasville,Georgia,29634,300,300,0,9/16/2021 13:12,9/18/2021 14:09
5803,1997-10-07,Thomasville,Hawaii,29634,2000,2000,0,9/16/2021 13:20,6/30/2022 12:34
5804,1995-02-11,Thomasville,Idaho,29634,400,400,0,9/16/2021 13:41,3/31/2022 22:55
5805,1996-08-23,Thomasville,Illinois,29634,200,200,0,9/16/2021 13:45,9/16/2021 18:25
5806,1992-10-21,Thomasville,Indiana,29634,300,300,0,9/16/2021 13:49,3/15/2022 9:02
5807,1978-08-05,Thomasville,Iowa,29634,330,330,0,9/16/2021 14:57,5/3/2022 6:19
5808,1997-03-16,Thomasville,Kansas,29634,700,700,0,9/16/2021 15:01,2/12/2022 15:19
5809,1991-08-20,Thomasville,Kentucky,29634,300,300,0,9/16/2021 15:05,1/23/2022 9:21
5810,2000-08-06,Thomasville,Louisiana,29634,2650,2650,0,9/16/2021 15:24,3/22/2022 10:08
5811,1985-01-24,Thomasville,Maine,29634,810,810,0,9/16/2021 15:51,5/9/2022 18:17
5812,2003-09-21,Thomasville,Maryland,29634,350,350,0,9/16/2021 16:07,3/22/2022 11:27
5813,1974-06-07,Thomasville,Massachusetts,29634,350,350,0,9/16/2021 16:08,1/18/2022 20:57
5814,2002-10-12,Thomasville,Michigan,29634,300,300,0,9/16/2021 16:12,9/18/2021 15:01
5815,1975-10-22,Thomasville,Minnesota,29634,300,300,0,9/16/2021 17:27,9/16/2021 17:29
5816,1994-07-20,Winston-Salem,North Carolina,27127,450,450,0,9/16/2021 17:40,12/9/2021 10:23
5817,1959-02-06,Thomasville,Mississippi,29634,650,650,0,9/16/2021 18:10,1/23/2022 8:49
5818,1986-09-30,Winston-Salem ,North Carolina,27104,1030,1030,0,9/16/2021 19:05,6/1/2022 7:35
5819,1995-05-30,Thomasville,Missouri,29634,400,400,0,9/16/2021 19:06,11/12/2021 22:57
5820,1983-11-21,Thomasville,Montana,29634,650,650,0,9/16/2021 19:07,10/30/2021 17:41
5821,1980-12-18,Thomasville,Nebraska,29634,4510,4510,0,9/16/2021 19:08,5/11/2022 17:58
5822,2000-10-01,Thomasville,Nevada,29634,300,300,0,9/16/2021 19:42,2/27/2022 21:18
5823,1984-01-28,Thomasville,New Hampshire,29634,640,1140,500,9/16/2021 19:50,6/30/2022 7:44
5824,1951-01-08,Thomasville,New Jersey,29634,1000,1000,0,9/16/2021 21:05,3/15/2022 14:39
5825,1999-06-21,Thomasville,New Mexico,29634,3910,3910,0,9/16/2021 21:52,4/16/2022 18:12
5826,1966-05-24,Thomasville,New York,29634,600,600,0,9/16/2021 22:06,3/16/2022 18:26
5827,1992-10-19,Thomasville,North Carolina,29634,300,300,0,9/16/2021 22:13,3/11/2022 22:21
5828,1991-11-22,Thomasville,North Dakota,29634,400,400,0,9/16/2021 22:25,10/18/2021 15:28
5829,1954-05-03,Thomasville,Ohio,29634,1000,1000,0,9/16/2021 22:53,3/26/2022 17:19
5830,1997-09-26,Thomasville,Oklahoma,29634,820,820,0,9/17/2021 7:57,2/2/2022 14:58
5831,1961-05-08,Thomasville,Oregon,29634,300,300,0,9/17/2021 9:59,3/30/2022 16:42
5832,1957-05-28,Thomasville,Pennsylvania,29634,300,300,0,9/17/2021 11:22,1/10/2022 10:34
5833,1991-10-01,Thomasville,Rhode Island,29634,300,300,0,9/17/2021 11:49,1/24/2022 17:49
5834,1957-09-16,Thomasville,South Carolina,29634,350,350,0,9/17/2021 12:22,3/14/2022 9:03
5835,1967-06-16,Thomasville,South Dakota,29634,300,300,0,9/17/2021 12:36,1/12/2022 12:30
5836,1999-06-08,Thomasville,Tennessee,29634,400,400,0,9/17/2021 13:09,1/22/2022 11:23
5837,1983-09-11,Thomasville,Texas,29634,310,310,0,9/17/2021 13:23,4/13/2022 9:06
5838,2001-05-16,Thomasville,Utah,29634,300,300,0,9/17/2021 13:34,11/13/2021 18:13
5839,1956-06-22,Thomasville,Vermont,29634,300,300,0,9/17/2021 13:49,3/14/2022 10:00
5840,1970-05-05,Thomasville,Virginia,29634,660,660,0,9/17/2021 14:08,10/2/2021 11:50
5841,1983-12-14,Thomasville,Washington,29634,300,300,0,9/17/2021 14:10,11/29/2021 15:35
5842,1996-07-16,Thomasville,West Virginia,29634,300,300,0,9/17/2021 14:14,2/22/2022 11:12
5843,1994-10-08,Thomasville,Wisconsin,29634,400,400,0,9/17/2021 14:20,11/30/2021 16:03
5844,2001-09-15,Thomasville,Wyoming,29634,310,310,0,9/17/2021 14:21,5/11/2022 13:02
5845,1997-03-03,Thomasville,Alabama,29634,760,760,0,9/17/2021 14:35,3/18/2022 16:14
5846,1999-04-02,Thomasville,Alaska,29634,1130,10630,9500,9/17/2021 15:11,6/16/2022 13:19
5847,1993-10-15,Thomasville,Arizona,29634,8840,8840,0,9/17/2021 15:22,5/26/2022 21:15
5848,1986-03-01,Thomasville,Arkansas,29634,310,310,0,9/17/2021 15:28,4/30/2022 10:20
5849,1999-05-17,Thomasville,California,29634,300,300,0,9/17/2021 15:38,2/3/2022 20:31
5850,1960-11-24,Thomasville,Colorado,29634,300,300,0,9/17/2021 15:57,12/4/2021 14:05
5851,1997-06-02,Thomasville,Connecticut,29634,450,450,0,9/17/2021 16:19,1/19/2022 18:26
5852,1975-01-26,Thomasville,Delaware,29634,300,300,0,9/17/2021 16:22,11/12/2021 13:08
5853,1986-06-07,Thomasville,District of Columbia,29634,1160,1160,0,9/17/2021 16:24,4/18/2022 18:18
5854,2004-07-04,Thomasville,Florida,29634,550,550,0,9/17/2021 16:38,1/27/2022 18:49
5855,1965-08-12,Thomasville,Georgia,29634,350,350,0,9/17/2021 17:03,1/20/2022 13:49
5856,1963-03-06,Thomasville,Hawaii,29634,500,500,0,9/17/2021 17:17,11/28/2021 0:45
5857,1953-08-24,Thomasville,Idaho,29634,4000,4000,0,9/17/2021 17:19,4/23/2022 10:17
5858,1984-01-17,Thomasville,Illinois,29634,300,300,0,9/17/2021 17:24,9/18/2021 13:27
5859,1992-04-10,Thomasville,Indiana,29634,300,300,0,9/17/2021 17:28,12/16/2021 14:42
5860,1982-12-09,Thomasville,Iowa,29634,300,300,0,9/17/2021 17:31,9/18/2021 15:18
5861,1985-08-24,Thomasville,Kansas,29634,300,300,0,9/17/2021 17:31,3/2/2022 21:03
5862,1967-06-16,Thomasville,Kentucky,29634,300,300,0,9/17/2021 17:44,1/12/2022 17:23
5863,1985-08-05,Thomasville,Louisiana,29634,650,650,0,9/17/2021 17:56,3/1/2022 12:00
5864,1967-07-10,Thomasville,Maine,29634,300,300,0,9/17/2021 17:56,2/26/2022 18:57
5865,2003-04-01,Thomasville,Maryland,29634,400,400,0,9/17/2021 18:12,10/30/2021 18:04
5866,1987-12-18,Thomasville,Massachusetts,29634,550,550,0,9/17/2021 18:25,2/26/2022 18:47
5867,1962-10-22,Thomasville,Michigan,29634,600,600,0,9/17/2021 18:32,10/15/2021 17:19
5868,1971-05-18,Thomasville,Minnesota,29634,300,300,0,9/17/2021 18:40,9/17/2021 18:41
5869,2004-02-11,Thomasville,Mississippi,29634,15125,15125,0,9/17/2021 19:12,6/21/2022 14:09
5870,1985-08-24,Thomasville,Missouri,29634,660,1160,500,9/17/2021 19:13,4/7/2022 18:15
5871,2005-09-04,Thomasville,Montana,29634,2600,2600,0,9/17/2021 19:23,1/22/2022 12:51
5872,2000-04-07,Thomasville,Nebraska,29634,300,300,0,9/17/2021 19:27,9/18/2021 16:27
5873,1974-06-04,Thomasville,Nevada,29634,2810,2810,0,9/17/2021 19:35,6/13/2022 18:27
5874,1982-01-22,Thomasville,New Hampshire,29634,350,350,0,9/17/2021 19:52,11/3/2021 17:57
5875,1974-03-09,Thomasville,New Jersey,29634,350,350,0,9/17/2021 19:59,11/27/2021 22:00
5876,1968-10-26,Thomasville,New Mexico,29634,300,300,0,9/17/2021 19:59,11/27/2021 21:28
5877,1981-12-24,Thomasville,New York,29634,470,470,0,9/17/2021 20:20,5/9/2022 19:47
5878,1996-10-02,Thomasville,North Carolina,29634,850,850,0,9/17/2021 20:23,1/13/2022 18:42
5879,1996-12-11,Thomasville,North Dakota,29634,350,350,0,9/17/2021 20:33,3/1/2022 20:01
5880,1985-04-14,Thomasville,Ohio,29634,1430,1430,0,9/17/2021 20:34,5/12/2022 10:43
5881,1957-08-05,Thomasville,Oklahoma,29634,370,370,0,9/17/2021 20:49,5/20/2022 19:17
5882,1983-01-22,Thomasville,Oregon,29634,600,600,0,9/17/2021 21:18,3/15/2022 16:51
5883,1969-10-05,Thomasville,Pennsylvania,29634,350,350,0,9/17/2021 22:19,11/11/2021 14:30
5884,1999-09-05,Thomasville,Rhode Island,29634,350,350,0,9/18/2021 2:00,1/10/2022 19:32
5885,1992-04-16,Thomasville,South Carolina,29634,750,750,0,9/18/2021 8:00,2/26/2022 19:02
5886,2002-03-13,Thomasville,South Dakota,29634,700,700,0,9/18/2021 8:24,11/27/2021 19:18
5887,2002-04-08,Thomasville,Tennessee,29634,310,310,0,9/18/2021 9:22,4/8/2022 18:59
5888,1985-04-18,Thomasville,Texas,29634,300,300,0,9/18/2021 10:31,9/18/2021 16:20
5889,1999-08-06,Thomasville,Utah,29634,400,400,0,9/18/2021 10:31,3/19/2022 8:09
5890,1990-12-20,Thomasville,Vermont,29634,400,400,0,9/18/2021 10:32,11/13/2021 19:10
5891,1995-01-21,Thomasville,Virginia,29634,100,600,500,9/18/2021 10:59,2/7/2022 10:48
5892,1972-02-25,Thomasville,Washington,29634,1750,1750,0,9/18/2021 11:14,4/23/2022 10:36
5893,1992-03-09,Thomasville,West Virginia,29634,1100,1100,0,9/18/2021 11:14,3/2/2022 12:13
5894,1997-08-11,Thomasville,Wisconsin,29634,300,300,0,9/18/2021 11:40,2/19/2022 12:26
5895,1962-02-08,Thomasville,Wyoming,29634,350,350,0,9/18/2021 11:48,11/21/2021 9:20
5896,1965-11-17,Thomasville,Alabama,29634,350,350,0,9/18/2021 11:53,11/28/2021 0:15
5897,1962-03-12,Thomasville,Alaska,29634,350,350,0,9/18/2021 11:53,9/21/2021 10:22
5898,1963-07-28,Thomasville,Arizona,29634,450,450,0,9/18/2021 11:56,3/7/2022 10:32
5899,1998-10-12,Thomasville,Arkansas,29634,1220,1220,0,9/18/2021 12:00,5/3/2022 19:39
5900,1981-11-26,Thomasville,California,29634,350,350,0,9/18/2021 12:02,1/20/2022 13:50
5901,1996-06-25,Thomasville,Colorado,29634,1010,1010,0,9/18/2021 12:03,4/8/2022 19:56
5902,1992-10-01,Thomasville,Connecticut,29634,460,460,0,9/18/2021 12:07,6/12/2022 22:27
5903,1992-11-17,Thomasville,Delaware,29634,400,400,0,9/18/2021 12:17,11/29/2021 14:21
5904,1998-10-05,Thomasville,District of Columbia,29634,450,450,0,9/18/2021 12:21,2/26/2022 18:09
5905,1999-10-24,Thomasville,Florida,29634,670,670,0,9/18/2021 12:22,12/21/2021 11:52
5906,1997-10-08,Thomasville,Georgia,29634,460,460,0,9/18/2021 12:31,5/11/2022 13:01
5907,2002-02-05,Thomasville,Hawaii,29634,1360,1360,0,9/18/2021 12:33,5/10/2022 18:04
5908,2000-01-04,Thomasville,Idaho,29634,770,770,0,9/18/2021 12:33,4/16/2022 16:46
5909,1958-01-22,Thomasville,Illinois,29634,350,350,0,9/18/2021 12:52,1/12/2022 16:58
5910,1998-10-04,Thomasville,Indiana,29634,410,410,0,9/18/2021 12:52,6/5/2022 7:58
5911,1989-12-03,Thomasville,Iowa,29634,300,300,0,9/18/2021 12:53,11/13/2021 17:04
5912,1982-06-17,Thomasville,Kansas,29634,900,900,0,9/18/2021 12:58,2/9/2022 9:34
5913,1970-04-20,Thomasville,Kentucky,29634,400,400,0,9/18/2021 13:06,11/13/2021 19:37
5914,1982-09-17,Thomasville,Louisiana,29634,300,300,0,9/18/2021 13:10,10/30/2021 15:00
5915,1958-10-05,Thomasville,Maine,29634,650,650,0,9/18/2021 13:10,3/2/2022 20:18
5916,1958-06-18,Thomasville,Maryland,29634,100,600,500,9/18/2021 13:12,6/27/2022 13:21
5917,1987-11-02,Thomasville,Massachusetts,29634,400,400,0,9/18/2021 13:12,11/13/2021 19:29
5918,1997-05-10,Thomasville,Michigan,29634,350,350,0,9/18/2021 13:13,3/2/2022 20:52
5919,1991-07-10,Thomasville,Minnesota,29634,1100,1100,0,9/18/2021 13:17,2/12/2022 14:45
5920,2004-09-11,Thomasville,Mississippi,29634,300,300,0,9/18/2021 13:19,10/30/2021 14:18
5921,1963-03-07,Thomasville,Missouri,29634,1980,1980,0,9/18/2021 13:24,6/12/2022 16:33
5922,1991-11-13,Thomasville,Montana,29634,360,360,0,9/18/2021 13:27,4/8/2022 22:26
5923,1960-12-15,Thomasville,Nebraska,29634,900,900,0,9/18/2021 13:28,3/25/2022 18:41
5924,1980-07-16,Thomasville,Nevada,29634,870,870,0,9/18/2021 13:30,4/18/2022 11:30
5925,2001-09-26,Thomasville,New Hampshire,29634,450,950,500,9/18/2021 13:35,3/19/2022 0:22
5926,1993-03-11,Thomasville,New Jersey,29634,1000,1000,0,9/18/2021 13:37,3/20/2022 13:08
5927,2000-11-17,Thomasville,New Mexico,29634,560,560,0,9/18/2021 13:44,3/14/2022 7:43
5928,1997-02-03,Thomasville,New York,29634,900,900,0,9/18/2021 13:53,3/2/2022 20:47
5929,1986-06-27,Thomasville,North Carolina,29634,300,300,0,9/18/2021 13:55,10/30/2021 15:01
5930,1969-03-17,Thomasville,North Dakota,29634,300,300,0,9/18/2021 13:58,9/18/2021 13:58
5931,1950-12-18,Thomasville,Ohio,29634,300,300,0,9/18/2021 14:05,3/24/2022 18:10
5932,2000-04-18,Thomasville,Oklahoma,29634,2370,2370,0,9/18/2021 14:06,4/16/2022 19:18
5933,1957-05-08,Thomasville,Oregon,29634,450,450,0,9/18/2021 14:07,1/10/2022 9:15
5934,2001-08-10,Thomasville,Pennsylvania,29634,2730,3230,500,9/18/2021 14:10,3/15/2022 18:37
5935,1977-08-23,Thomasville,Rhode Island,29634,300,300,0,9/18/2021 14:11,2/2/2022 18:44
5936,1972-07-26,Thomasville,South Carolina,29634,2920,2920,0,9/18/2021 14:18,5/27/2022 2:02
5937,1973-06-02,Thomasville,South Dakota,29634,1810,1810,0,9/18/2021 14:19,5/3/2022 23:01
5938,1992-07-17,Thomasville,Tennessee,29634,360,360,0,9/18/2021 14:26,4/8/2022 18:41
5939,1961-10-15,Thomasville,Texas,29634,400,400,0,9/18/2021 14:28,2/11/2022 23:30
5940,1966-10-14,Thomasville,Utah,29634,300,300,0,9/18/2021 14:35,3/13/2022 22:20
5941,1958-03-01,Thomasville,Vermont,29634,1060,1060,0,9/18/2021 14:38,4/18/2022 18:01
5942,1976-01-20,Thomasville,Virginia,29634,1050,1050,0,9/18/2021 14:40,3/22/2022 22:28
5943,2021-10-18,Thomasville,Washington,29634,1630,2130,500,9/18/2021 14:43,1/22/2022 18:55
5944,1952-02-12,Thomasville,West Virginia,29634,300,300,0,9/18/2021 14:44,1/22/2022 18:53
5945,1960-02-12,Thomasville,Wisconsin,29634,430,430,0,9/18/2021 14:46,4/28/2022 16:57
5946,2000-02-15,Thomasville,Wyoming,29634,450,450,0,9/18/2021 14:59,12/4/2021 18:01
5947,1976-10-28,Thomasville,Alabama,29634,300,300,0,9/18/2021 15:05,9/18/2021 15:15
5948,2000-04-23,Thomasville,Alaska,29634,5310,19810,14500,9/18/2021 15:05,6/5/2022 23:34
5949,1994-11-19,Thomasville,Arizona,29634,1150,1650,500,9/18/2021 15:06,6/30/2022 17:12
5950,1982-10-21,Thomasville,Arkansas,29634,300,300,0,9/18/2021 15:16,9/18/2021 15:26
5951,1961-09-08,Thomasville,California,29634,350,350,0,9/18/2021 15:16,1/12/2022 9:13
5952,1961-08-25,Thomasville,Colorado,29634,650,650,0,9/18/2021 15:17,1/12/2022 16:59
5953,1980-03-20,Thomasville,Connecticut,29634,350,350,0,9/18/2021 15:33,9/18/2021 15:37
5954,1966-01-10,Thomasville,Delaware,29634,650,650,0,9/18/2021 15:42,12/4/2021 23:11
5955,2000-01-04,Thomasville,District of Columbia,29634,410,410,0,9/18/2021 15:48,4/12/2022 19:42
5956,1987-10-23,Thomasville,Florida,29634,350,350,0,9/18/2021 15:51,1/22/2022 18:00
5957,1986-05-02,Thomasville,Georgia,29634,300,300,0,9/18/2021 16:09,11/27/2021 16:38
5958,1994-04-03,Thomasville,Hawaii,29634,650,650,0,9/18/2021 16:10,1/11/2022 19:15
5959,1974-04-05,Thomasville,Idaho,29634,230,1730,1500,9/18/2021 16:10,4/18/2022 22:01
5960,1973-01-23,Thomasville,Illinois,29634,950,950,0,9/18/2021 16:10,3/2/2022 21:40
5961,1986-12-21,Thomasville,Indiana,29634,1260,1260,0,9/18/2021 16:11,4/8/2022 11:23
5962,1992-09-22,Thomasville,Iowa,29634,60,3560,3500,9/18/2021 16:13,4/27/2022 12:20
5963,1970-12-02,Thomasville,Kansas,29634,300,300,0,9/18/2021 16:19,1/12/2022 18:35
5964,1978-03-04,Thomasville,Kentucky,29634,4630,22630,18000,9/18/2021 17:12,6/6/2022 4:53
5965,1997-03-22,Thomasville,Louisiana,29634,350,350,0,9/18/2021 17:52,3/30/2022 11:00
5966,1993-05-01,Thomasville,Maine,29634,300,300,0,9/18/2021 20:21,9/18/2021 20:23
5967,1970-10-23,Thomasville,Maryland,29634,300,300,0,9/20/2021 12:33,2/17/2022 14:56
5968,1960-02-20,Thomasville,Massachusetts,29634,1160,1160,0,9/20/2021 14:33,5/3/2022 17:52
5969,1981-09-19,Thomasville,Michigan,29634,300,300,0,9/20/2021 20:26,9/27/2021 20:36
5970,1997-09-14,Thomasville,Minnesota,29634,300,300,0,9/20/2021 21:06,1/18/2022 13:52
5971,2003-03-15,Thomasville,Mississippi,29634,5490,5990,500,9/20/2021 22:46,5/16/2022 11:28
5972,1996-08-02,Thomasville,Missouri,29634,510,510,0,9/21/2021 0:03,4/8/2022 10:32
5973,2002-10-19,Thomasville,Montana,29634,850,850,0,9/21/2021 15:20,3/1/2022 11:51
5974,1986-05-15,Winston-Salem,North Carolina,27101,900,900,0,9/21/2021 16:59,2/1/2022 13:11
5975,1989-04-16,Thomasville,Nebraska,29634,300,300,0,9/21/2021 17:54,10/13/2021 14:18
5976,1990-01-05,Thomasville,Nevada,29634,1910,1910,0,9/21/2021 20:24,6/30/2022 7:30
5977,1985-03-05,Thomasville,New Hampshire,29634,400,400,0,9/21/2021 20:38,11/8/2021 9:30
5978,1972-01-05,Thomasville,New Jersey,29634,350,350,0,9/21/2021 21:28,11/17/2021 9:50
5979,1969-12-09,Winston-Salem,North Carolina,27101,910,910,0,9/22/2021 10:28,5/6/2022 12:08
5980,1965-10-07,Thomasville,New Mexico,29634,300,300,0,9/22/2021 14:53,3/17/2022 12:00
5981,1997-06-27,Thomasville,New York,29634,1430,1430,0,9/22/2021 15:02,4/16/2022 16:24
5982,1978-04-02,Thomasville,North Carolina,29634,600,600,0,9/22/2021 15:29,2/7/2022 20:30
5983,1997-01-01,Thomasville,North Dakota,29634,450,450,0,9/22/2021 15:59,1/22/2022 19:10
5984,1979-11-03,Thomasville,Ohio,29634,900,900,0,9/22/2021 17:30,11/27/2021 21:58
5985,1974-08-03,Thomasville,Oklahoma,29634,650,650,0,9/22/2021 18:14,2/6/2022 10:39
5986,1995-01-26,Thomasville,Oregon,29634,400,400,0,9/22/2021 18:45,11/13/2021 23:41
5987,1997-10-07,Thomasville,Pennsylvania,29634,420,420,0,9/22/2021 20:37,4/29/2022 17:00
5988,1996-10-25,Thomasville,Rhode Island,29634,410,410,0,9/22/2021 21:03,4/27/2022 12:17
5989,1992-01-09,Thomasville,South Carolina,29634,400,400,0,9/22/2021 22:45,12/31/2021 2:30
5990,1963-06-05,Thomasville,South Dakota,29634,300,300,0,9/23/2021 14:46,11/19/2021 18:00
5991,1994-09-21,Thomasville,Tennessee,29634,410,410,0,9/23/2021 16:40,4/9/2022 15:02
5992,1969-06-10,Thomasville,Texas,29634,300,300,0,9/23/2021 17:50,11/25/2021 14:37
5993,1980-09-23,Thomasville,Utah,29634,300,300,0,9/23/2021 17:57,1/15/2022 17:23
5994,1977-09-05,Thomasville,Vermont,29634,300,300,0,9/23/2021 22:10,1/22/2022 13:44
5995,1971-08-09,Thomasville,Virginia,29634,670,670,0,9/24/2021 10:28,5/7/2022 12:45
5996,2005-10-02,Thomasville,Washington,29634,1400,1400,0,9/24/2021 11:11,2/1/2022 12:07
5997,1990-12-28,Thomasville,West Virginia,29634,1150,1150,0,9/24/2021 12:31,6/12/2022 15:03
5998,1975-11-04,Thomasville,Wisconsin,29634,300,300,0,9/24/2021 12:45,1/22/2022 19:23
5999,1999-02-03,Thomasville,Wyoming,29634,9080,9080,0,9/24/2021 17:50,6/30/2022 14:29
6000,1981-01-06,Thomasville,Alabama,29634,1910,1910,0,9/24/2021 18:07,5/3/2022 14:05
6001,1994-06-10,Thomasville,Alaska,29634,320,320,0,9/24/2021 18:53,4/18/2022 18:02
6002,1951-04-28,Thomasville,Arizona,29634,300,300,0,9/24/2021 19:52,10/31/2021 1:43
6003,1965-05-18,Thomasville,Arkansas,29634,650,650,0,9/25/2021 12:26,3/13/2022 22:26
6004,1955-06-10,Thomasville,California,29634,1000,1000,0,9/25/2021 15:38,3/8/2022 19:33
6005,1978-12-17,Thomasville,Colorado,29634,850,850,0,9/25/2021 18:16,1/25/2022 8:51
6006,1989-07-16,Thomasville,Connecticut,29634,320,320,0,9/25/2021 20:30,5/9/2022 10:34
6007,1973-03-14,Thomasville,Delaware,29634,860,860,0,9/25/2021 22:03,4/8/2022 9:10
6008,1989-10-18,Thomasville,District of Columbia,29634,400,400,0,9/26/2021 0:54,3/13/2022 23:37
6009,1951-10-08,Thomasville,Florida,29634,350,350,0,9/26/2021 11:07,3/21/2022 21:29
6010,1956-04-10,Thomasville,Georgia,29634,1050,1050,0,9/26/2021 15:47,3/21/2022 16:39
6011,1997-08-27,"Winston-Salem, NC",North Carolina,27106,1280,1280,0,9/26/2021 18:41,5/26/2022 20:50
6012,1957-05-27,Thomasville,Hawaii,29634,300,300,0,9/26/2021 22:18,11/13/2021 17:27
6013,1961-02-01,Thomasville,Idaho,29634,300,300,0,9/27/2021 7:47,10/20/2021 9:54
6014,1955-05-04,Thomasville,Illinois,29634,610,610,0,9/27/2021 9:16,5/8/2022 11:26
6015,1952-07-23,Thomasville,Indiana,29634,650,650,0,9/27/2021 14:38,1/18/2022 17:15
6016,1981-09-15,Thomasville,Iowa,29634,700,700,0,9/27/2021 14:54,1/22/2022 19:46
6017,1969-09-02,Thomasville,Kansas,29634,650,650,0,9/27/2021 15:17,1/22/2022 19:39
6018,2005-03-20,Thomasville,Kentucky,29634,500,500,0,9/27/2021 17:50,3/18/2022 16:01
6019,1982-07-04,Thomasville,Louisiana,29634,450,450,0,9/27/2021 17:53,1/22/2022 20:46
6020,1989-02-22,Thomasville,Maine,29634,1170,1170,0,9/27/2021 19:18,4/16/2022 16:15
6021,2001-10-23,Thomasville,Maryland,29634,350,350,0,9/27/2021 19:29,1/18/2022 21:22
6022,2004-05-04,Thomasville,Massachusetts,29634,350,350,0,9/27/2021 19:49,11/3/2021 19:24
6023,1992-04-14,Thomasville,Michigan,29634,750,750,0,9/27/2021 20:23,11/21/2021 19:23
6024,2004-04-03,Thomasville,Minnesota,29634,300,300,0,9/27/2021 23:16,10/2/2021 12:13
6025,1995-09-08,Thomasville,Mississippi,29634,650,650,0,9/28/2021 9:29,1/22/2022 20:44
6026,1996-01-01,Thomasville,Missouri,29634,300,300,0,9/28/2021 11:22,3/25/2022 10:07
6027,1966-06-17,Thomasville,Montana,29634,350,350,0,9/28/2021 11:50,11/2/2021 15:51
6028,1996-12-02,Thomasville,Nebraska,29634,550,550,0,9/28/2021 12:33,12/4/2021 13:31
6029,1959-03-08,Thomasville,Nevada,29634,570,570,0,9/28/2021 12:37,6/30/2022 4:57
6030,1996-11-15,Thomasville,New Hampshire,29634,300,300,0,9/28/2021 12:40,10/2/2021 11:45
6031,1962-10-27,Winston-Salem,North Carolina,27101,400,400,0,9/28/2021 14:05,10/28/2021 14:21
6032,1994-05-23,Thomasville,New Jersey,29634,560,560,0,9/28/2021 14:51,1/2/2022 19:14
6033,1957-01-03,Thomasville,New Mexico,29634,300,300,0,9/28/2021 19:02,9/28/2021 19:05
6034,1975-08-17,Thomasville,New York,29634,1000,1000,0,9/28/2021 19:12,2/10/2022 12:03
6035,2001-02-08,Thomasville,North Carolina,29634,400,400,0,9/28/2021 19:21,2/16/2022 19:10
6036,1984-05-18,Thomasville,North Dakota,29634,1860,1860,0,9/28/2021 19:21,3/19/2022 15:58
6037,1981-10-15,Thomasville,Ohio,29634,1930,1930,0,9/28/2021 19:39,12/23/2021 23:57
6038,1951-10-11,Thomasville,Oklahoma,29634,350,350,0,9/28/2021 19:42,1/22/2022 16:44
6039,1965-03-25,Thomasville,Oregon,29634,310,310,0,9/28/2021 19:50,4/27/2022 14:03
6040,1985-05-10,Thomasville,Pennsylvania,29634,300,300,0,9/28/2021 19:59,11/8/2021 19:00
6041,1960-01-01,Thomasville,Rhode Island,29634,300,300,0,9/28/2021 20:49,1/18/2022 17:57
6042,1996-04-01,Thomasville,South Carolina,29634,350,350,0,9/29/2021 9:47,1/22/2022 19:43
6043,1983-06-20,Thomasville,South Dakota,29634,300,300,0,9/29/2021 11:18,11/13/2021 18:02
6044,1988-03-27,Thomasville,Tennessee,29634,320,320,0,9/29/2021 11:23,5/7/2022 20:15
6045,1975-07-17,Thomasville,Texas,29634,300,300,0,9/29/2021 12:23,10/31/2021 11:48
6046,1998-10-08,Winston-Salem,North Carolina,27106,450,450,0,9/29/2021 12:24,11/13/2021 23:05
6047,1979-10-27,Winston-Salem,North Carolina,27106,160,2160,2000,9/29/2021 12:51,3/10/2022 16:02
6048,1992-09-24,Thomasville,Utah,29634,650,650,0,9/29/2021 14:00,12/4/2021 19:13
6049,1981-06-01,Thomasville,Vermont,29634,300,300,0,9/29/2021 14:00,10/2/2021 12:13
6050,1984-07-19,Thomasville,Virginia,29634,300,300,0,9/29/2021 14:02,11/13/2021 4:48
6051,1962-02-17,Thomasville,Washington,29634,300,300,0,9/29/2021 22:45,9/29/2021 22:46
6052,1969-03-17,Thomasville,West Virginia,29634,320,320,0,9/30/2021 9:54,4/12/2022 19:11
6053,1985-09-16,Thomasville,Wisconsin,29634,300,300,0,9/30/2021 10:57,1/18/2022 14:44
6054,1992-10-01,Thomasville,Wyoming,29634,300,300,0,9/30/2021 12:25,11/15/2021 18:17
6055,1958-09-07,Thomasville,Alabama,29634,310,310,0,9/30/2021 16:24,4/17/2022 13:26
6056,1990-11-25,Thomasville,Alaska,29634,350,350,0,9/30/2021 16:53,11/27/2021 20:00
6057,2004-10-16,Thomasville,Arizona,29634,450,450,0,9/30/2021 23:43,11/13/2021 16:09
6058,1995-01-22,Thomasville,Arkansas,29634,300,300,0,10/1/2021 5:16,11/28/2021 11:14
6059,1974-11-17,Thomasville,California,29634,450,450,0,10/1/2021 8:48,10/30/2021 15:41
6060,1985-07-16,Thomasville,Colorado,29634,500,2500,2000,10/1/2021 9:54,6/20/2022 8:30
6061,1988-08-06,Thomasville,Connecticut,29634,300,300,0,10/1/2021 10:03,1/13/2022 16:36
6062,1984-09-22,Thomasville,Delaware,29634,300,300,0,10/1/2021 10:08,11/27/2021 17:05
6063,1982-09-14,Thomasville,District of Columbia,29634,350,350,0,10/1/2021 10:18,11/30/2021 18:41
6064,1953-08-22,Thomasville,Florida,29634,560,560,0,10/1/2021 11:29,4/10/2022 12:14
6065,1978-06-26,Thomasville,Georgia,29634,650,650,0,10/1/2021 12:43,3/18/2022 2:50
6066,1956-03-04,Thomasville,Hawaii,29634,350,350,0,10/1/2021 13:56,2/15/2022 21:34
6067,2002-06-17,Thomasville,Idaho,29634,350,350,0,10/1/2021 13:57,11/3/2021 19:30
6068,1967-03-09,Thomasville,Illinois,29634,300,300,0,10/1/2021 14:35,11/30/2021 18:23
6069,1963-03-20,Thomasville,Indiana,29634,300,300,0,10/1/2021 15:07,3/16/2022 20:20
6070,1983-06-19,Thomasville,Iowa,29634,1200,1200,0,10/1/2021 15:57,3/16/2022 21:06
6071,1968-09-01,Thomasville,Kansas,29634,350,350,0,10/1/2021 16:40,1/12/2022 12:12
6072,1950-03-11,Thomasville,Kentucky,29634,350,350,0,10/1/2021 16:50,11/28/2021 21:00
6073,1978-07-20,Thomasville,Louisiana,29634,350,350,0,10/1/2021 17:51,11/13/2021 20:32
6074,1976-06-16,Thomasville,Maine,29634,610,610,0,10/1/2021 18:26,4/7/2022 18:01
6075,1987-12-18,Thomasville,Maryland,29634,350,350,0,10/1/2021 18:27,10/1/2021 22:03
6076,2000-11-22,Thomasville,Massachusetts,29634,750,750,0,10/1/2021 18:40,3/22/2022 11:15
6077,1996-06-12,Thomasville,Michigan,29634,350,350,0,10/1/2021 18:51,10/23/2021 12:21
6078,1962-11-10,Thomasville,Minnesota,29634,400,400,0,10/1/2021 19:01,2/9/2022 21:26
6079,1999-07-08,Thomasville,Mississippi,29634,350,350,0,10/1/2021 19:06,10/6/2021 12:48
6080,1982-01-16,Thomasville,Missouri,29634,1130,1130,0,10/1/2021 19:10,5/22/2022 0:46
6081,1981-07-27,Thomasville,Montana,29634,400,400,0,10/1/2021 19:25,11/18/2021 19:00
6082,1981-11-20,Thomasville,Nebraska,29634,360,360,0,10/1/2021 19:34,5/8/2022 9:25
6083,1956-12-12,Thomasville,Nevada,29634,300,300,0,10/1/2021 20:08,1/31/2022 17:23
6084,1973-07-02,Thomasville,New Hampshire,29634,300,300,0,10/1/2021 20:08,1/29/2022 14:55
6085,1965-02-23,Thomasville,New Jersey,29634,750,750,0,10/1/2021 20:17,1/22/2022 21:51
6086,1979-08-23,Thomasville,New Mexico,29634,300,300,0,10/1/2021 20:20,11/13/2021 13:15
6087,2001-09-08,Thomasville,New York,29634,450,450,0,10/1/2021 21:04,1/21/2022 22:00
6088,1970-07-04,Thomasville,North Carolina,29634,310,310,0,10/1/2021 21:21,5/4/2022 15:15
6089,1973-09-17,Thomasville,North Dakota,29634,310,310,0,10/1/2021 21:47,4/13/2022 9:00
6090,1967-07-15,Thomasville,Ohio,29634,300,300,0,10/1/2021 22:11,1/21/2022 16:44
6091,1994-01-27,Thomasville,Oklahoma,29634,300,300,0,10/1/2021 22:12,2/19/2022 10:14
6092,2001-04-23,Thomasville,Oregon,29634,300,300,0,10/1/2021 22:53,11/27/2021 17:24
6093,1998-02-06,Thomasville,Pennsylvania,29634,400,400,0,10/1/2021 23:04,11/27/2021 18:01
6094,1952-08-11,Thomasville,Rhode Island,29634,500,500,0,10/1/2021 23:16,1/29/2022 15:56
6095,1959-11-19,Thomasville,South Carolina,29634,300,300,0,10/1/2021 23:49,10/2/2021 12:06
6096,1957-05-17,Thomasville,South Dakota,29634,300,300,0,10/2/2021 0:25,3/19/2022 16:12
6097,1999-09-14,Thomasville,Tennessee,29634,850,850,0,10/2/2021 1:11,3/16/2022 17:22
6098,2005-10-04,Thomasville,Texas,29634,200,700,500,10/2/2021 1:21,12/4/2021 10:12
6099,2003-03-08,Thomasville,Utah,29634,650,650,0,10/2/2021 9:06,1/10/2022 19:21
6100,1974-03-01,Thomasville,Vermont,29634,600,600,0,10/2/2021 9:09,3/26/2022 15:38
6101,1955-03-15,Thomasville,Virginia,29634,800,800,0,10/2/2021 9:19,1/12/2022 18:29
6102,1974-04-16,Thomasville,Washington,29634,960,960,0,10/2/2021 9:43,5/13/2022 21:44
6103,1970-09-06,Thomasville,West Virginia,29634,560,560,0,10/2/2021 9:48,5/3/2022 17:32
6104,1992-08-02,Thomasville,Wisconsin,29634,300,300,0,10/2/2021 10:03,3/5/2022 15:33
6105,1979-12-21,Thomasville,Wyoming,29634,300,300,0,10/2/2021 10:18,10/26/2021 18:02
6106,1954-08-17,Thomasville,Alabama,29634,370,370,0,10/2/2021 10:30,6/21/2022 14:49
6107,2001-07-04,Thomasville,Alaska,29634,950,950,0,10/2/2021 10:32,3/2/2022 20:56
6108,1964-02-04,Thomasville,Arizona,29634,360,360,0,10/2/2021 10:47,6/7/2022 20:17
6109,2003-03-11,Thomasville,Arkansas,29634,300,300,0,10/2/2021 10:49,1/22/2022 14:39
6110,1981-09-15,Thomasville,California,29634,1230,1230,0,10/2/2021 11:14,4/13/2022 9:00
6111,1974-09-07,Thomasville,Colorado,29634,120,3120,3000,10/2/2021 11:21,4/10/2022 9:26
6112,2004-09-26,Thomasville,Connecticut,29634,350,350,0,10/2/2021 11:24,11/27/2021 18:24
6113,2002-03-01,Thomasville,Delaware,29634,610,610,0,10/2/2021 11:31,4/18/2022 14:02
6114,1958-01-24,Thomasville,District of Columbia,29634,300,300,0,10/2/2021 11:36,3/19/2022 20:00
6115,1969-07-11,Thomasville,Florida,29634,510,510,0,10/2/2021 11:40,4/23/2022 15:21
6116,1996-01-04,Thomasville,Georgia,29634,450,450,0,10/2/2021 11:42,1/22/2022 15:14
6117,1998-06-06,Thomasville,Hawaii,29634,520,520,0,10/2/2021 11:48,6/3/2022 18:35
6118,1993-11-08,Walkertown,North Carolina,27051,1580,1580,0,10/2/2021 12:00,4/18/2022 18:01
6119,1995-10-31,Winston-Salem,North Carolina,27101,450,450,0,10/2/2021 12:05,12/2/2021 14:54
6120,1975-09-12,Thomasville,Idaho,29634,1330,1330,0,10/2/2021 12:35,4/16/2022 16:25
6121,1994-12-12,Thomasville,Illinois,29634,750,13750,13000,10/2/2021 12:57,5/9/2022 16:00
6122,2000-07-10,Thomasville,Indiana,29634,720,720,0,10/2/2021 13:00,4/29/2022 16:45
6123,1980-02-06,Thomasville,Iowa,29634,600,600,0,10/2/2021 13:00,3/14/2022 14:14
6124,1996-10-06,Thomasville,Kansas,29634,300,300,0,10/2/2021 14:16,1/22/2022 20:04
6125,1996-10-12,Thomasville,Kentucky,29634,660,660,0,10/2/2021 14:44,5/22/2022 17:21
6126,1950-04-09,Thomasville,Louisiana,29634,300,300,0,10/3/2021 20:45,11/13/2021 19:07
6127,1974-05-17,Thomasville,Maine,29634,460,460,0,10/5/2021 19:18,5/3/2022 17:39
6128,1972-05-06,Thomasville,Maryland,29634,400,400,0,10/5/2021 19:19,2/12/2022 9:18
6129,1977-05-04,Thomasville,Massachusetts,29634,1380,1380,0,10/5/2021 19:42,6/13/2022 16:54
6130,1964-10-03,Thomasville,Michigan,29634,450,450,0,10/5/2021 19:59,10/5/2021 20:11
6131,1989-02-04,Thomasville,Minnesota,29634,710,710,0,10/5/2021 20:55,12/5/2021 15:12
6132,1968-12-26,Thomasville,Mississippi,29634,300,300,0,10/5/2021 22:06,10/30/2021 18:20
6133,1951-06-01,Thomasville,Missouri,29634,320,320,0,10/6/2021 12:20,5/3/2022 12:32
6134,1998-01-08,Thomasville,Montana,29634,750,750,0,10/6/2021 14:13,2/22/2022 11:12
6135,1996-11-12,Winston-Salem,North Carolina,27106,1420,2920,1500,10/6/2021 16:52,6/30/2022 12:46
6136,1960-01-16,Thomasville,Nebraska,29634,310,310,0,10/6/2021 22:09,6/29/2022 15:47
6137,1980-01-01,Thomasville,Nevada,29634,410,410,0,10/8/2021 17:50,12/4/2021 21:55
6138,1961-05-17,Thomasville,New Hampshire,29634,350,350,0,10/10/2021 14:27,3/6/2022 10:37
6139,1996-01-02,Thomasville,New Jersey,29634,300,300,0,10/10/2021 16:08,1/22/2022 19:29
6140,1964-09-07,Thomasville,New Mexico,29634,500,500,0,10/10/2021 17:21,2/26/2022 19:07
6141,1972-07-06,Thomasville,New York,29634,860,860,0,10/10/2021 18:48,6/15/2022 14:35
6142,2000-06-16,Thomasville,North Carolina,29634,850,850,0,10/10/2021 18:48,1/24/2022 17:16
6143,1988-11-12,Thomasville,North Dakota,29634,300,300,0,10/10/2021 22:19,11/23/2021 5:38
6144,2021-05-23,Charlotte,North Carolina,28205,250,750,500,10/11/2021 8:47,1/6/2022 14:16
6145,1985-11-24,Thomasville,Ohio,29634,300,300,0,10/11/2021 14:01,1/8/2022 13:40
6146,2001-01-02,Thomasville,Oklahoma,29634,310,310,0,10/12/2021 8:00,4/12/2022 5:35
6147,1976-07-25,Thomasville,Oregon,29634,300,300,0,10/12/2021 15:36,1/22/2022 18:00
6148,1969-03-15,Thomasville,Pennsylvania,29634,300,300,0,10/12/2021 15:42,1/12/2022 18:11
6149,1991-05-11,Thomasville,Rhode Island,29634,310,310,0,10/12/2021 15:59,4/15/2022 8:47
6150,1964-08-08,Thomasville,South Carolina,29634,450,450,0,10/12/2021 18:58,2/12/2022 15:41
6151,1965-03-17,Thomasville,South Dakota,29634,650,650,0,10/12/2021 19:08,3/13/2022 10:34
6152,1957-12-16,Thomasville,Tennessee,29634,300,300,0,10/12/2021 19:19,10/28/2021 16:03
6153,1966-05-08,Thomasville,Texas,29634,460,460,0,10/12/2021 19:32,5/4/2022 12:06
6154,2001-03-22,Thomasville,Utah,29634,2360,4360,2000,10/12/2021 20:44,3/19/2022 16:05
6155,1972-03-23,Thomasville,Vermont,29634,300,300,0,10/13/2021 14:41,10/14/2021 20:23
6156,1994-06-03,Thomasville,Virginia,29634,950,950,0,10/13/2021 15:15,1/18/2022 22:00
6157,1994-12-29,Thomasville,Washington,29634,750,750,0,10/13/2021 15:18,1/12/2022 19:03
6158,1985-08-07,Thomasville,West Virginia,29634,100,100,0,10/13/2021 20:22,10/13/2021 20:27
6159,1999-03-23,Thomasville,Wisconsin,29634,770,770,0,10/13/2021 20:25,5/6/2022 19:17
6160,1966-03-23,Thomasville,Wyoming,29634,300,300,0,10/14/2021 10:52,2/10/2022 9:48
6161,1997-04-13,Thomasville,Alabama,29634,400,400,0,10/14/2021 11:53,3/2/2022 20:59
6162,1988-12-17,Thomasville,Alaska,29634,320,320,0,10/14/2021 14:07,5/25/2022 17:07
6163,1987-05-14,Thomasville,Arizona,29634,400,400,0,10/14/2021 16:45,3/19/2022 16:02
6164,1997-10-22,Thomasville,Arkansas,29634,310,310,0,10/14/2021 20:05,6/6/2022 18:16
6165,1993-02-27,Thomasville,California,29634,300,300,0,10/14/2021 22:44,11/14/2021 12:56
6166,1997-06-02,Thomasville,Colorado,29634,660,660,0,10/15/2021 8:34,5/17/2022 16:00
6167,1997-10-31,Thomasville,Connecticut,29634,410,410,0,10/15/2021 13:21,4/24/2022 19:59
6168,2003-05-16,Thomasville,Delaware,29634,1590,1590,0,10/15/2021 16:20,1/12/2022 20:46
6169,1986-11-23,Thomasville,District of Columbia,29634,300,300,0,10/15/2021 16:39,2/24/2022 17:45
6170,1991-09-17,Thomasville,Florida,29634,900,900,0,10/15/2021 16:47,11/30/2021 12:31
6171,1974-05-25,Thomasville,Georgia,29634,300,800,500,10/15/2021 16:50,12/1/2021 10:20
6172,1978-03-20,Thomasville,Hawaii,29634,300,300,0,10/15/2021 16:56,10/15/2021 19:34
6173,1980-03-16,Thomasville,Idaho,29634,370,370,0,10/15/2021 17:45,5/11/2022 17:48
6174,1975-04-15,Thomasville,Illinois,29634,4360,4360,0,10/15/2021 18:09,5/26/2022 10:28
6175,2002-07-18,Thomasville,Indiana,29634,600,600,0,10/15/2021 18:25,10/27/2021 15:47
6176,1973-06-05,Thomasville,Iowa,29634,1390,1390,0,10/15/2021 19:00,6/19/2022 11:47
6177,2002-07-20,Thomasville,Kansas,29634,300,300,0,10/15/2021 19:28,3/26/2022 10:38
6178,1954-08-08,Thomasville,Kentucky,29634,650,650,0,10/15/2021 19:59,2/26/2022 21:27
6179,2003-07-11,Thomasville,Louisiana,29634,300,300,0,10/16/2021 18:00,11/13/2021 11:49
6180,2000-10-11,Thomasville,Maine,29634,310,310,0,10/16/2021 19:09,4/26/2022 13:58
6181,1970-01-22,Thomasville,Maryland,29634,300,300,0,10/16/2021 19:29,11/7/2021 16:25
6182,1972-02-10,Thomasville,Massachusetts,29634,450,450,0,10/16/2021 19:35,10/30/2021 9:54
6183,1991-04-10,Thomasville,Michigan,29634,950,950,0,10/16/2021 19:37,2/19/2022 11:11
6184,1994-11-22,Thomasville,Minnesota,29634,400,400,0,10/16/2021 19:41,11/13/2021 19:55
6185,1962-10-24,Thomasville,Mississippi,29634,3330,3330,0,10/16/2021 19:55,5/7/2022 19:43
6186,2001-09-26,Thomasville,Missouri,29634,2210,2210,0,10/16/2021 19:56,4/9/2022 17:53
6187,2000-11-22,Thomasville,Montana,29634,510,510,0,10/17/2021 12:18,4/11/2022 14:17
6188,1976-06-11,Thomasville,Nebraska,29634,650,650,0,10/18/2021 14:37,1/12/2022 18:41
6189,1984-08-24,Thomasville,Nevada,29634,350,350,0,10/18/2021 14:57,3/15/2022 20:05
6190,2000-03-17,Thomasville,New Hampshire,29634,300,300,0,10/18/2021 22:08,2/19/2022 10:35
6191,1998-03-13,Thomasville,New Jersey,29634,1780,3280,1500,10/18/2021 22:11,6/28/2022 6:02
6192,1982-03-19,Thomasville,New Mexico,29634,850,850,0,10/18/2021 22:46,3/2/2022 20:57
6193,1972-05-18,Thomasville,New York,29634,660,660,0,10/18/2021 23:18,6/3/2022 16:22
6194,1991-10-27,Thomasville,North Carolina,29634,560,560,0,10/19/2021 7:44,3/22/2022 7:00
6195,1997-08-07,Thomasville,North Dakota,29634,300,300,0,10/19/2021 7:57,1/18/2022 16:38
6196,1990-11-11,Thomasville,Ohio,29634,300,300,0,10/19/2021 9:24,11/13/2021 19:54
6197,1995-12-28,Thomasville,Oklahoma,29634,560,560,0,10/19/2021 15:28,1/28/2022 8:34
6198,1999-09-03,Thomasville,Oregon,29634,550,550,0,10/19/2021 18:18,11/15/2021 19:32
6199,1954-09-07,Thomasville,Pennsylvania,29634,300,300,0,10/19/2021 18:39,10/21/2021 7:23
6200,1992-11-07,Thomasville,Rhode Island,29634,450,450,0,10/19/2021 19:13,11/13/2021 19:40
6201,1966-12-09,Thomasville,South Carolina,29634,310,310,0,10/19/2021 19:18,4/15/2022 22:13
6202,1973-06-17,Thomasville,South Dakota,29634,1110,1110,0,10/19/2021 19:53,3/25/2022 10:17
6203,1993-01-12,Thomasville,Tennessee,29634,510,510,0,10/19/2021 21:51,5/11/2022 18:22
6204,2004-02-25,Thomasville,Texas,29634,300,300,0,10/20/2021 12:26,3/26/2022 12:48
6205,1962-09-05,Thomasville,Utah,29634,300,300,0,10/21/2021 17:24,3/15/2022 9:02
6206,1965-08-17,Thomasville,Vermont,29634,550,550,0,10/21/2021 18:25,3/26/2022 17:52
6207,1981-06-10,Thomasville,Virginia,29634,710,710,0,10/21/2021 18:36,6/9/2022 16:26
6208,1991-11-01,Thomasville,Washington,29634,600,600,0,10/21/2021 18:41,4/4/2022 11:48
6209,1961-10-03,Thomasville,West Virginia,29634,300,300,0,10/21/2021 18:41,1/21/2022 21:44
6210,1972-07-03,Thomasville,Wisconsin,29634,1190,2690,1500,10/21/2021 18:57,5/5/2022 14:37
6211,1968-07-20,Thomasville,Wyoming,29634,300,300,0,10/21/2021 19:03,11/27/2021 21:35
6212,1985-01-08,Thomasville,Alabama,29634,1100,1100,0,10/21/2021 19:07,3/19/2022 17:31
6213,1966-12-20,Thomasville,Alaska,29634,300,300,0,10/21/2021 19:18,11/27/2021 19:04
6214,1989-09-28,Thomasville,Arizona,29634,300,300,0,10/22/2021 12:59,1/22/2022 11:59
6215,1961-03-11,Thomasville,Arkansas,29634,300,300,0,10/22/2021 15:03,11/1/2021 16:08
6216,1997-01-16,Thomasville,California,29634,650,650,0,10/22/2021 15:21,1/18/2022 19:52
6217,1975-08-14,Thomasville,Colorado,29634,300,300,0,10/22/2021 19:00,3/13/2022 22:14
6218,2000-01-26,Thomasville,Connecticut,29634,300,300,0,10/22/2021 21:08,10/30/2021 22:13
6219,1995-01-26,Winston-Salem,North Carolina,27101,400,400,0,10/23/2021 9:51,10/30/2021 12:56
6220,2001-05-26,Thomasville,Delaware,29634,300,300,0,10/23/2021 13:56,11/10/2021 16:26
6221,1980-03-05,Thomasville,District of Columbia,29634,850,850,0,10/23/2021 18:05,3/2/2022 20:52
6222,1958-05-14,Thomasville,Florida,29634,760,760,0,10/24/2021 7:57,5/17/2022 21:40
6223,1967-02-21,Thomasville,Georgia,29634,350,350,0,10/24/2021 9:17,2/12/2022 15:16
6224,2004-04-14,Thomasville,Hawaii,29634,650,650,0,10/24/2021 11:22,2/19/2022 13:07
6225,2004-12-12,Thomasville,Idaho,29634,500,500,0,10/24/2021 12:30,10/24/2021 16:30
6226,1951-07-06,Thomasville,Illinois,29634,960,960,0,10/24/2021 14:37,1/12/2022 20:40
6227,1965-06-01,Thomasville,Indiana,29634,300,300,0,10/24/2021 15:08,3/23/2022 9:00
6228,2005-07-09,Thomasville,Iowa,29634,320,320,0,10/24/2021 15:35,5/20/2022 15:32
6229,1992-12-22,Thomasville,Kansas,29634,350,350,0,10/24/2021 16:09,1/20/2022 20:34
6230,1972-02-16,Thomasville,Kentucky,29634,900,900,0,10/24/2021 19:00,1/26/2022 15:06
6231,1982-04-07,Thomasville,Louisiana,29634,350,350,0,10/24/2021 20:14,5/26/2022 12:00
6232,1998-09-26,Thomasville,Maine,29634,410,410,0,10/24/2021 20:42,4/21/2022 19:54
6233,1962-03-20,Thomasville,Maryland,29634,300,300,0,10/24/2021 22:03,3/25/2022 12:52
6234,2002-02-12,Winston-Salem,North Carolina,27109,710,710,0,10/24/2021 23:28,5/8/2022 20:31
6235,1980-09-15,Thomasville,Massachusetts,29634,810,810,0,10/25/2021 10:15,3/25/2022 9:46
6236,1984-10-18,Thomasville,Michigan,29634,680,680,0,10/25/2021 17:55,6/23/2022 6:46
6237,1958-12-25,Thomasville,Minnesota,29634,390,390,0,10/25/2021 18:32,5/3/2022 14:23
6238,1998-05-20,Thomasville,Mississippi,29634,750,750,0,10/25/2021 19:06,11/5/2021 20:35
6239,1951-04-22,Thomasville,Missouri,29634,600,600,0,10/25/2021 19:28,1/22/2022 19:48
6240,1965-08-21,Thomasville,Montana,29634,300,300,0,10/25/2021 19:40,10/30/2021 16:01
6241,1966-05-08,Thomasville,Nebraska,29634,650,650,0,10/25/2021 19:45,2/12/2022 15:02
6242,1965-02-19,Thomasville,Nevada,29634,300,300,0,10/26/2021 9:09,12/1/2021 10:19
6243,1950-10-07,Thomasville,New Hampshire,29634,350,350,0,10/26/2021 10:03,5/6/2022 16:24
6244,1998-12-28,Thomasville,New Jersey,29634,820,820,0,10/26/2021 11:33,6/1/2022 0:52
6245,1990-11-01,Thomasville,New Mexico,29634,600,600,0,10/26/2021 12:50,1/22/2022 19:35
6246,1993-09-25,Thomasville,New York,29634,400,400,0,10/26/2021 13:21,1/12/2022 18:43
6247,1998-12-01,Thomasville,North Carolina,29634,300,300,0,10/26/2021 13:57,10/30/2021 16:08
6248,1952-09-20,Thomasville,North Dakota,29634,300,300,0,10/26/2021 15:19,10/30/2021 15:31
6249,1989-07-01,Thomasville,Ohio,29634,650,650,0,10/26/2021 15:53,1/22/2022 19:32
6250,1960-10-01,Thomasville,Oklahoma,29634,1230,1230,0,10/26/2021 17:16,5/6/2022 18:27
6251,1992-10-07,Thomasville,Oregon,29634,300,300,0,10/26/2021 17:19,11/13/2021 18:37
6252,1955-10-23,Thomasville,Pennsylvania,29634,350,350,0,10/26/2021 17:52,10/30/2021 16:20
6253,1959-07-01,Thomasville,Rhode Island,29634,350,350,0,10/26/2021 19:11,2/3/2022 12:08
6254,1954-10-04,Thomasville,South Carolina,29634,310,310,0,10/26/2021 19:36,4/8/2022 16:45
6255,1976-03-15,Thomasville,South Dakota,29634,650,650,0,10/26/2021 20:08,11/17/2021 9:29
6256,1995-11-23,Thomasville,Tennessee,29634,300,300,0,10/26/2021 20:11,1/18/2022 22:01
6257,1996-11-15,Thomasville,Texas,29634,350,350,0,10/26/2021 21:59,3/14/2022 10:02
6258,1983-03-04,Thomasville,Utah,29634,300,300,0,10/27/2021 8:25,12/9/2021 17:01
6259,1967-03-08,Thomasville,Vermont,29634,310,310,0,10/27/2021 10:02,4/9/2022 9:55
6260,2002-11-28,Thomasville,Virginia,29634,350,350,0,10/27/2021 10:17,10/30/2021 15:53
6261,1996-01-22,Thomasville,Washington,29634,400,400,0,10/27/2021 14:06,4/3/2022 12:34
6262,1952-05-21,Thomasville,West Virginia,29634,350,350,0,10/27/2021 15:53,2/10/2022 8:48
6263,1997-03-11,Thomasville,Wisconsin,29634,400,400,0,10/27/2021 17:04,11/3/2021 18:42
6264,1963-08-20,Thomasville,Wyoming,29634,300,300,0,10/27/2021 17:48,10/27/2021 17:51
6265,1984-06-27,Thomasville,Alabama,29634,300,300,0,10/27/2021 17:49,10/27/2021 17:51
6266,1993-03-24,Thomasville,Alaska,29634,650,650,0,10/27/2021 19:45,2/21/2022 23:56
6267,1986-06-04,Thomasville,Arizona,29634,400,400,0,10/27/2021 21:07,3/15/2022 9:02
6268,2002-11-11,Thomasville,Arkansas,29634,300,300,0,10/27/2021 22:17,3/16/2022 19:02
6269,1996-05-28,Thomasville,California,29634,300,300,0,10/28/2021 9:17,11/13/2021 17:32
6270,1972-08-09,Thomasville,Colorado,29634,350,350,0,10/28/2021 9:49,4/1/2022 7:25
6271,1987-08-08,Thomasville,Connecticut,29634,300,300,0,10/28/2021 10:09,10/30/2021 15:59
6272,1998-10-21,Thomasville,Delaware,29634,400,400,0,10/28/2021 11:04,3/12/2022 10:44
6273,1977-12-09,Thomasville,District of Columbia,29634,400,400,0,10/28/2021 11:26,3/22/2022 8:42
6274,1989-10-02,Thomasville,Florida,29634,600,600,0,10/28/2021 12:15,1/12/2022 18:20
6275,1990-12-16,Thomasville,Georgia,29634,350,350,0,10/28/2021 12:28,10/30/2021 16:07
6276,1994-09-23,Thomasville,Hawaii,29634,400,400,0,10/28/2021 12:52,3/23/2022 14:52
6277,1977-04-20,Thomasville,Idaho,29634,1000,1000,0,10/28/2021 14:31,2/1/2022 20:03
6278,1997-12-13,Thomasville,Illinois,29634,400,400,0,10/28/2021 14:44,12/3/2021 17:27
6279,2001-03-15,Thomasville,Indiana,29634,450,450,0,10/28/2021 15:07,10/30/2021 15:58
6280,1953-06-27,Thomasville,Iowa,29634,660,660,0,10/28/2021 15:08,1/12/2022 18:12
6281,1954-11-22,Thomasville,Kansas,29634,350,350,0,10/28/2021 15:27,1/12/2022 18:20
6282,1973-11-07,Thomasville,Kentucky,29634,650,650,0,10/28/2021 15:29,1/12/2022 18:20
6283,1957-10-25,Thomasville,Louisiana,29634,300,300,0,10/28/2021 16:05,3/1/2022 21:53
6284,1998-08-14,Thomasville,Maine,29634,700,700,0,10/28/2021 17:54,2/14/2022 18:15
6285,1998-05-08,Thomasville,Maryland,29634,2910,2910,0,10/28/2021 18:02,5/18/2022 18:41
6286,1976-06-03,Thomasville,Massachusetts,29634,300,300,0,10/28/2021 18:49,11/13/2021 19:26
6287,1997-06-14,Thomasville,Michigan,29634,340,340,0,10/28/2021 19:00,6/10/2022 19:26
6288,1965-09-21,Thomasville,Minnesota,29634,310,310,0,10/28/2021 20:20,1/20/2022 20:17
6289,1979-06-21,Thomasville,Mississippi,29634,650,650,0,10/28/2021 21:10,3/17/2022 10:58
6290,1969-10-10,Thomasville,Missouri,29634,300,300,0,10/28/2021 21:34,3/28/2022 19:54
6291,1997-08-26,Winston-Salem,North Carolina,27106,800,800,0,10/28/2021 23:03,1/18/2022 18:01
6292,1968-01-05,Thomasville,Montana,29634,350,350,0,10/28/2021 23:39,2/26/2022 18:50
6293,1993-05-06,Thomasville,Nebraska,29634,300,300,0,10/29/2021 0:13,10/29/2021 11:40
6294,1976-08-04,Thomasville,Nevada,29634,310,310,0,10/29/2021 9:34,4/10/2022 14:42
6295,1979-09-21,Thomasville,New Hampshire,29634,1110,1110,0,10/29/2021 9:54,4/8/2022 18:38
6296,1988-05-10,Thomasville,New Jersey,29634,300,300,0,10/29/2021 10:14,10/30/2021 16:23
6297,1964-04-10,Thomasville,New Mexico,29634,350,350,0,10/29/2021 10:35,11/27/2021 20:01
6298,1994-06-01,Thomasville,New York,29634,400,400,0,10/29/2021 11:43,2/17/2022 14:02
6299,2002-07-12,Thomasville,North Carolina,29634,400,400,0,10/29/2021 11:48,12/4/2021 15:12
6300,1953-03-19,Thomasville,North Dakota,29634,2350,2350,0,10/29/2021 11:59,3/25/2022 11:39
6301,2001-04-28,Thomasville,Ohio,29634,350,350,0,10/29/2021 12:16,10/30/2021 16:07
6302,1995-07-04,Thomasville,Oklahoma,29634,570,570,0,10/29/2021 12:51,4/18/2022 20:10
6303,2001-07-07,Thomasville,Oregon,29634,350,350,0,10/29/2021 13:08,11/27/2021 20:28
6304,1963-11-20,Thomasville,Pennsylvania,29634,300,300,0,10/29/2021 13:16,3/1/2022 22:40
6305,1958-02-12,Thomasville,Rhode Island,29634,310,310,0,10/29/2021 13:31,4/19/2022 18:54
6306,2003-01-18,Thomasville,South Carolina,29634,400,400,0,10/29/2021 13:42,2/9/2022 21:51
6307,1975-03-15,Thomasville,South Dakota,29634,650,650,0,10/29/2021 14:26,12/3/2021 21:01
6308,2001-02-25,Thomasville,Tennessee,29634,300,300,0,10/29/2021 14:50,3/24/2022 18:00
6309,1962-09-16,Thomasville,Texas,29634,300,300,0,10/29/2021 15:07,3/10/2022 16:55
6310,1962-09-15,Thomasville,Utah,29634,1640,1640,0,10/29/2021 15:52,1/17/2022 10:18
6311,1960-04-18,Thomasville,Vermont,29634,350,350,0,10/29/2021 15:59,12/25/2021 11:13
6312,1978-12-04,Thomasville,Virginia,29634,300,300,0,10/29/2021 16:32,10/30/2021 16:04
6313,1964-06-15,Thomasville,Washington,29634,300,300,0,10/29/2021 16:52,10/29/2021 16:56
6314,1953-07-03,Thomasville,West Virginia,29634,300,300,0,10/29/2021 18:49,1/12/2022 18:54
6315,1961-05-21,Thomasville,Wisconsin,29634,350,350,0,10/29/2021 19:23,1/2/2022 4:31
6316,1960-01-19,Thomasville,Wyoming,29634,1420,1420,0,10/29/2021 19:53,5/23/2022 9:19
6317,1998-07-18,Thomasville,Alabama,29634,900,900,0,10/29/2021 20:26,3/16/2022 17:27
6318,1957-08-19,Winston-Salem,North Carolina,27107,200,200,0,10/29/2021 21:04,10/29/2021 21:06
6319,1953-08-03,Thomasville,Alaska,29634,300,300,0,10/29/2021 21:14,1/25/2022 18:27
6320,1971-12-26,Thomasville,Arizona,29634,800,800,0,10/29/2021 21:27,3/25/2022 17:57
6321,1992-11-29,Thomasville,Arkansas,29634,400,400,0,10/29/2021 23:13,10/30/2021 15:32
6322,1951-09-19,Thomasville,California,29634,450,450,0,10/30/2021 1:09,12/9/2021 19:01
6323,1975-08-16,Thomasville,Colorado,29634,300,300,0,10/30/2021 2:04,10/30/2021 2:33
6324,1958-10-26,Thomasville,Connecticut,29634,300,300,0,10/30/2021 10:24,1/22/2022 20:21
6325,1998-11-25,Thomasville,Delaware,29634,300,300,0,10/30/2021 10:51,11/29/2021 19:00
6326,1963-01-28,Thomasville,District of Columbia,29634,520,520,0,10/30/2021 10:52,6/5/2022 20:36
6327,1967-10-03,Thomasville,Florida,29634,300,300,0,10/30/2021 10:53,10/30/2021 16:14
6328,1956-10-08,Thomasville,Georgia,29634,300,300,0,10/30/2021 11:02,1/12/2022 17:01
6329,1986-10-05,Thomasville,Hawaii,29634,300,300,0,10/30/2021 11:06,1/12/2022 13:18
6330,2005-11-28,Thomasville,Idaho,29634,2800,2800,0,10/30/2021 11:09,6/30/2022 22:04
6331,1979-12-04,Thomasville,Illinois,29634,1980,1980,0,10/30/2021 11:22,4/18/2022 17:14
6332,1999-01-06,Thomasville,Indiana,29634,300,300,0,10/30/2021 11:30,10/30/2021 16:13
6333,1994-09-07,Thomasville,Iowa,29634,300,300,0,10/30/2021 11:31,10/30/2021 11:32
6334,1993-12-04,Thomasville,Kansas,29634,310,310,0,10/30/2021 11:34,4/29/2022 16:09
6335,1988-12-04,Thomasville,Kentucky,29634,300,300,0,10/30/2021 11:38,10/30/2021 16:26
6336,1959-11-21,Thomasville,Louisiana,29634,650,650,0,10/30/2021 12:02,11/13/2021 19:56
6337,1965-12-28,Thomasville,Maine,29634,300,300,0,10/30/2021 12:08,2/19/2022 12:45
6338,1951-03-20,Thomasville,Maryland,29634,350,350,0,10/30/2021 12:29,1/12/2022 19:07
6339,1997-03-13,Thomasville,Massachusetts,29634,300,300,0,10/30/2021 12:38,1/19/2022 13:55
6340,1959-07-07,Thomasville,Michigan,29634,300,300,0,10/30/2021 12:42,1/12/2022 13:12
6341,1996-09-08,Thomasville,Minnesota,29634,300,300,0,10/30/2021 12:58,1/21/2022 13:56
6342,1976-04-26,Thomasville,Mississippi,29634,300,300,0,10/30/2021 13:01,11/30/2021 18:53
6343,1994-03-08,Thomasville,Missouri,29634,520,520,0,10/30/2021 13:15,5/18/2022 15:29
6344,1994-08-10,Thomasville,Montana,29634,450,450,0,10/30/2021 13:20,11/13/2021 20:02
6345,1960-04-15,Thomasville,Nebraska,29634,900,900,0,10/30/2021 13:38,3/18/2022 16:01
6346,1971-10-03,Thomasville,Nevada,29634,650,650,0,10/30/2021 13:39,3/20/2022 0:47
6347,2000-02-17,Thomasville,New Hampshire,29634,250,750,500,10/30/2021 14:07,2/5/2022 19:29
6348,1981-02-12,Thomasville,New Jersey,29634,300,300,0,10/30/2021 14:09,2/28/2022 9:41
6349,1995-09-19,Thomasville,New Mexico,29634,2380,2380,0,10/30/2021 14:10,5/11/2022 18:09
6350,1985-08-07,Thomasville,New York,29634,300,300,0,10/30/2021 14:14,10/30/2021 16:04
6351,2002-10-24,Thomasville,North Carolina,29634,800,800,0,10/30/2021 14:25,4/2/2022 17:48
6352,1950-05-26,Thomasville,North Dakota,29634,300,300,0,10/30/2021 14:25,3/1/2022 12:05
6353,1974-12-02,Thomasville,Ohio,29634,350,350,0,10/30/2021 14:27,12/1/2021 10:20
6354,1996-10-11,Thomasville,Oklahoma,29634,300,300,0,10/30/2021 14:27,3/26/2022 15:20
6355,1977-03-10,Thomasville,Oregon,29634,300,300,0,10/30/2021 14:32,10/30/2021 14:43
6356,1988-12-11,Thomasville,Pennsylvania,29634,360,360,0,10/30/2021 14:33,4/27/2022 9:00
6357,1983-10-18,Thomasville,Rhode Island,29634,300,300,0,10/30/2021 14:34,11/13/2021 18:44
6358,1953-01-15,Thomasville,South Carolina,29634,300,300,0,10/30/2021 14:34,2/22/2022 9:41
6359,1971-11-08,Thomasville,South Dakota,29634,350,350,0,10/30/2021 14:45,10/30/2021 14:45
6360,1988-06-04,Thomasville,Tennessee,29634,300,300,0,10/30/2021 14:45,10/30/2021 14:46
6361,1998-01-10,Thomasville,Texas,29634,450,450,0,10/30/2021 14:48,11/30/2021 11:27
6362,1951-10-16,Thomasville,Utah,29634,400,400,0,10/30/2021 14:49,1/21/2022 13:47
6363,2002-09-17,Thomasville,Vermont,29634,300,300,0,10/30/2021 14:51,2/28/2022 9:00
6364,1969-02-10,Thomasville,Virginia,29634,660,660,0,10/30/2021 14:53,5/2/2022 18:41
6365,2004-02-16,Thomasville,Washington,29634,300,300,0,10/30/2021 14:53,10/30/2021 15:03
6366,1985-06-05,Thomasville,West Virginia,29634,900,900,0,10/30/2021 14:55,3/14/2022 11:29
6367,2002-06-06,Thomasville,Wisconsin,29634,300,300,0,10/30/2021 14:56,1/22/2022 19:38
6368,1951-07-06,Thomasville,Wyoming,29634,350,350,0,10/30/2021 14:57,11/13/2021 19:02
6369,1950-11-10,Thomasville,Alabama,29634,310,310,0,10/30/2021 15:00,4/8/2022 12:22
6370,2002-04-22,Thomasville,Alaska,29634,580,1080,500,10/30/2021 15:03,4/8/2022 8:57
6371,1957-06-02,Thomasville,Arizona,29634,450,450,0,10/30/2021 15:04,3/2/2022 21:17
6372,1990-07-04,Thomasville,Arkansas,29634,660,660,0,10/30/2021 15:08,5/7/2022 12:21
6373,1980-05-13,Thomasville,California,29634,350,350,0,10/30/2021 15:09,2/22/2022 20:06
6374,1956-05-01,Thomasville,Colorado,29634,320,320,0,10/30/2021 15:13,5/10/2022 18:29
6375,2001-04-05,Thomasville,Connecticut,29634,300,300,0,10/30/2021 15:15,11/13/2021 18:13
6376,1989-11-22,Thomasville,Delaware,29634,500,500,0,10/30/2021 15:16,3/19/2022 15:52
6377,2005-08-09,Thomasville,District of Columbia,29634,300,300,0,10/30/2021 15:17,1/20/2022 20:42
6378,2001-02-11,Thomasville,Florida,29634,450,450,0,10/30/2021 15:19,1/12/2022 17:03
6379,1979-01-04,Thomasville,Georgia,29634,300,300,0,10/30/2021 15:20,1/12/2022 16:20
6380,1960-02-11,Thomasville,Hawaii,29634,350,350,0,10/30/2021 15:21,2/26/2022 19:19
6381,1992-09-22,Thomasville,Idaho,29634,600,600,0,10/30/2021 15:22,3/25/2022 10:09
6382,1970-11-11,Thomasville,Illinois,29634,370,370,0,10/30/2021 15:25,4/9/2022 16:01
6383,1955-11-01,Thomasville,Indiana,29634,300,300,0,10/30/2021 15:35,2/19/2022 13:00
6384,1952-08-16,Thomasville,Iowa,29634,300,300,0,10/30/2021 15:37,11/18/2021 10:38
6385,1985-09-10,Thomasville,Kansas,29634,390,390,0,10/30/2021 15:41,4/11/2022 17:37
6386,2004-03-26,Thomasville,Kentucky,29634,300,300,0,10/30/2021 15:42,2/2/2022 16:49
6387,1958-08-08,Thomasville,Louisiana,29634,400,400,0,10/30/2021 15:42,1/12/2022 18:10
6388,1962-07-24,Thomasville,Maine,29634,300,300,0,10/30/2021 15:42,1/21/2022 13:57
6389,1984-02-24,Thomasville,Maryland,29634,350,350,0,10/30/2021 15:44,11/13/2021 19:09
6390,1986-08-17,Thomasville,Massachusetts,29634,300,300,0,10/30/2021 15:47,10/30/2021 16:12
6391,2001-06-16,Thomasville,Michigan,29634,300,300,0,10/30/2021 15:49,11/13/2021 19:55
6392,1983-03-14,Thomasville,Minnesota,29634,360,360,0,10/30/2021 15:55,4/11/2022 15:54
6393,1979-01-03,Thomasville,Mississippi,29634,300,300,0,10/30/2021 15:56,11/30/2021 18:15
6394,1951-08-22,Thomasville,Missouri,29634,350,350,0,10/30/2021 15:59,1/20/2022 14:25
6395,1988-12-09,Thomasville,Montana,29634,360,360,0,10/30/2021 16:05,4/21/2022 20:53
6396,1996-09-12,Thomasville,Nebraska,29634,300,300,0,10/30/2021 16:06,2/10/2022 21:02
6397,1995-04-15,Thomasville,Nevada,29634,300,300,0,10/30/2021 16:06,1/22/2022 13:39
6398,1999-11-27,Thomasville,New Hampshire,29634,370,370,0,10/30/2021 16:08,5/29/2022 22:54
6399,2003-07-11,Thomasville,New Jersey,29634,300,300,0,10/30/2021 16:09,2/22/2022 9:54
6400,1971-02-26,Thomasville,New Mexico,29634,1070,1070,0,10/30/2021 16:37,6/17/2022 2:56
6401,1992-05-03,Thomasville,New York,29634,300,300,0,10/30/2021 16:46,1/19/2022 9:17
6402,1994-06-08,Thomasville,North Carolina,29634,650,650,0,10/30/2021 16:46,10/30/2021 16:50
6403,1970-12-14,Thomasville,North Dakota,29634,310,310,0,10/30/2021 17:58,4/11/2022 19:27
6404,1988-10-18,Thomasville,Ohio,29634,600,600,0,10/31/2021 13:00,3/17/2022 18:30
6405,1987-01-14,Thomasville,Oklahoma,29634,300,300,0,10/31/2021 19:37,1/17/2022 16:45
6406,1984-05-06,Thomasville,Oregon,29634,300,300,0,10/31/2021 20:28,11/13/2021 19:00
6407,1995-11-28,Thomasville,Pennsylvania,29634,300,300,0,11/1/2021 20:44,3/15/2022 17:11
6408,1996-06-24,Thomasville,Rhode Island,29634,870,870,0,11/2/2021 11:14,4/19/2022 17:58
6409,1996-12-07,Thomasville,South Carolina,29634,800,800,0,11/2/2021 11:23,3/2/2022 21:45
6410,1995-09-16,Thomasville,South Dakota,29634,1050,1050,0,11/2/2021 23:00,1/22/2022 11:37
6411,1955-01-14,Thomasville,Tennessee,29634,300,300,0,11/3/2021 12:56,11/3/2021 12:56
6412,1998-12-02,Thomasville,Texas,29634,760,760,0,11/3/2021 13:47,4/8/2022 11:10
6413,1969-04-09,Thomasville,Utah,29634,300,300,0,11/3/2021 14:13,11/4/2021 16:07
6414,1952-08-15,Thomasville,Vermont,29634,300,300,0,11/4/2021 13:00,3/25/2022 18:07
6415,1958-04-18,Winston-Salem,North Carolina,27103,450,450,0,11/4/2021 14:26,3/1/2022 14:10
6416,1974-07-24,Thomasville,Virginia,29634,450,450,0,11/5/2021 13:21,11/5/2021 19:56
6417,1989-06-14,Thomasville,Washington,29634,300,300,0,11/6/2021 10:57,11/9/2021 13:08
6418,1988-02-22,Thomasville,West Virginia,29634,300,300,0,11/6/2021 12:34,11/27/2021 15:57
6419,1958-06-07,Thomasville,Wisconsin,29634,350,350,0,11/6/2021 12:38,2/19/2022 11:07
6420,1996-02-14,Thomasville,Wyoming,29634,400,400,0,11/7/2021 13:19,1/22/2022 18:34
6421,1953-05-23,Thomasville,Alabama,29634,370,370,0,11/7/2021 14:13,5/10/2022 7:58
6422,1969-12-25,Thomasville,Alaska,29634,310,310,0,11/7/2021 14:26,5/1/2022 7:28
6423,1975-08-23,Thomasville,Arizona,29634,300,300,0,11/7/2021 14:26,11/13/2021 19:37
6424,1996-01-11,Thomasville,Arkansas,29634,1230,1230,0,11/7/2021 15:59,5/29/2022 23:15
6425,2004-03-20,Thomasville,California,29634,300,300,0,11/7/2021 16:27,3/25/2022 23:38
6426,1996-01-11,Thomasville,Colorado,29634,400,400,0,11/7/2021 17:32,11/7/2021 17:52
6427,1997-08-15,Thomasville,Connecticut,29634,450,450,0,11/7/2021 17:47,12/7/2021 6:53
6428,1969-04-19,Thomasville,Delaware,29634,310,310,0,11/8/2021 9:10,4/16/2022 20:59
6429,1997-03-06,Thomasville,District of Columbia,29634,460,460,0,11/8/2021 9:22,4/21/2022 20:59
6430,1951-10-27,Thomasville,Florida,29634,300,300,0,11/8/2021 9:47,11/11/2021 20:22
6431,1954-05-26,Thomasville,Georgia,29634,350,350,0,11/8/2021 10:03,12/2/2021 18:26
6432,1958-03-16,Thomasville,Hawaii,29634,300,300,0,11/8/2021 11:51,3/2/2022 20:58
6433,1956-02-28,Thomasville,Idaho,29634,300,300,0,11/8/2021 11:51,2/17/2022 14:06
6434,1980-06-01,Thomasville,Illinois,29634,300,300,0,11/8/2021 13:13,12/31/2021 16:03
6435,2001-01-02,Thomasville,Indiana,29634,650,650,0,11/8/2021 15:58,11/14/2021 11:50
6436,1983-11-19,Thomasville,Iowa,29634,400,400,0,11/8/2021 16:33,11/13/2021 19:33
6437,1966-04-10,Thomasville,Kansas,29634,300,300,0,11/8/2021 16:34,11/8/2021 16:34
6438,1993-08-26,Winston-Salem ,North Carolina,27106,590,590,0,11/8/2021 16:55,5/8/2022 10:39
6439,1995-08-03,Winston-Salem,North Carolina,27103,400,400,0,11/8/2021 19:19,1/26/2022 15:15
6440,1977-10-04,Thomasville,Kentucky,29634,310,310,0,11/8/2021 20:18,6/23/2022 17:58
6441,1969-08-21,Thomasville,Louisiana,29634,660,660,0,11/8/2021 20:40,4/8/2022 20:03
6442,1955-01-16,Thomasville,Maine,29634,300,300,0,11/9/2021 9:28,11/27/2021 19:32
6443,1996-02-13,Thomasville,Maryland,29634,740,740,0,11/9/2021 10:55,6/17/2022 1:38
6444,1975-11-25,Thomasville,Massachusetts,29634,300,300,0,11/9/2021 10:59,12/8/2021 12:10
6445,1962-08-06,Thomasville,Michigan,29634,350,350,0,11/9/2021 12:03,1/13/2022 13:21
6446,1987-05-14,Thomasville,Minnesota,29634,300,300,0,11/9/2021 13:54,1/11/2022 10:42
6447,1955-11-12,Thomasville,Mississippi,29634,300,300,0,11/9/2021 13:58,11/13/2021 17:48
6448,1976-06-05,Thomasville,Missouri,29634,300,300,0,11/9/2021 14:27,1/17/2022 9:06
6449,1956-06-01,Thomasville,Montana,29634,300,300,0,11/9/2021 14:39,11/15/2021 18:21
6450,1996-05-16,Thomasville,Nebraska,29634,200,200,0,11/9/2021 14:47,11/9/2021 14:49
6451,2005-05-03,Thomasville,Nevada,29634,300,300,0,11/9/2021 17:24,12/28/2021 9:57
6452,1992-02-17,Thomasville,New Hampshire,29634,1240,1240,0,11/9/2021 20:07,6/6/2022 18:23
6453,1997-03-01,Thomasville,New Jersey,29634,450,450,0,11/10/2021 9:58,1/17/2022 19:00
6454,1998-06-30,Thomasville,New Mexico,29634,400,400,0,11/10/2021 10:36,3/13/2022 22:19
6455,2000-01-15,Thomasville,New York,29634,300,300,0,11/10/2021 11:19,3/14/2022 10:18
6456,1994-09-08,Thomasville,North Carolina,29634,420,420,0,11/10/2021 11:23,5/6/2022 15:36
6457,1972-09-22,Thomasville,North Dakota,29634,300,300,0,11/10/2021 11:24,11/18/2021 16:00
6458,2000-07-16,Thomasville,Ohio,29634,300,300,0,11/10/2021 11:26,3/9/2022 22:43
6459,2002-04-28,Thomasville,Oklahoma,29634,710,710,0,11/10/2021 11:35,3/6/2022 17:09
6460,1986-02-14,Thomasville,Oregon,29634,310,310,0,11/10/2021 11:37,4/21/2022 9:37
6461,1962-05-22,Thomasville,Pennsylvania,29634,300,300,0,11/10/2021 13:51,11/10/2021 13:58
6462,1997-04-13,Thomasville,Rhode Island,29634,400,400,0,11/10/2021 15:16,2/25/2022 7:18
6463,1969-02-21,Thomasville,South Carolina,29634,500,500,0,11/10/2021 15:34,3/5/2022 16:08
6464,1970-02-28,Thomasville,South Dakota,29634,610,610,0,11/10/2021 16:02,5/25/2022 14:21
6465,1983-04-26,Thomasville,Tennessee,29634,300,300,0,11/10/2021 17:18,11/13/2021 19:30
6466,1967-05-01,Thomasville,Texas,29634,300,300,0,11/10/2021 17:44,11/28/2021 12:15
6467,2001-10-14,Thomasville,Utah,29634,560,560,0,11/10/2021 17:52,4/15/2022 10:17
6468,1991-04-03,Thomasville,Vermont,29634,350,350,0,11/10/2021 17:59,1/12/2022 7:39
6469,1956-10-19,Thomasville,Virginia,29634,300,300,0,11/10/2021 18:50,4/6/2022 9:00
6470,1998-11-02,Thomasville,Washington,29634,2260,2260,0,11/10/2021 18:52,3/19/2022 16:41
6471,1972-11-03,Thomasville,West Virginia,29634,300,300,0,11/10/2021 18:59,11/16/2021 19:10
6472,2004-07-11,Thomasville,Wisconsin,29634,300,300,0,11/10/2021 19:13,11/18/2021 19:08
6473,1969-11-19,Thomasville,Wyoming,29634,700,700,0,11/10/2021 19:15,1/23/2022 20:17
6474,1972-10-24,Thomasville,Alabama,29634,1260,1260,0,11/10/2021 19:15,4/8/2022 18:35
6475,1951-02-27,Thomasville,Alaska,29634,350,350,0,11/10/2021 19:48,3/13/2022 11:23
6476,2001-08-08,Thomasville,Arizona,29634,500,500,0,11/10/2021 19:51,3/16/2022 19:32
6477,1979-03-07,Thomasville,Arkansas,29634,300,300,0,11/10/2021 20:10,2/26/2022 18:47
6478,1968-01-04,Thomasville,California,29634,350,350,0,11/10/2021 20:27,11/30/2021 9:50
6479,1995-01-21,Thomasville,Colorado,29634,400,400,0,11/10/2021 20:55,11/13/2021 20:09
6480,1960-04-14,Thomasville,Connecticut,29634,350,350,0,11/10/2021 20:58,2/3/2022 13:46
6481,1959-05-28,Thomasville,Delaware,29634,300,300,0,11/10/2021 21:11,1/26/2022 16:32
6482,1999-06-07,Thomasville,District of Columbia,29634,600,600,0,11/10/2021 21:17,1/23/2022 14:05
6483,2004-08-21,Thomasville,Florida,29634,300,300,0,11/10/2021 22:03,11/30/2021 11:52
6484,1987-03-02,Thomasville,Georgia,29634,650,650,0,11/10/2021 22:20,11/30/2021 18:12
6485,1966-01-13,Thomasville,Hawaii,29634,650,650,0,11/10/2021 22:21,11/30/2021 18:13
6486,2000-11-06,Thomasville,Idaho,29634,550,550,0,11/10/2021 22:45,1/22/2022 20:51
6487,1999-12-15,Thomasville,Illinois,29634,400,400,0,11/11/2021 0:43,2/19/2022 13:50
6488,2002-04-11,Thomasville,Indiana,29634,2100,2100,0,11/11/2021 8:32,6/30/2022 15:45
6489,1996-07-03,Thomasville,Iowa,29634,350,350,0,11/11/2021 11:27,12/28/2021 19:08
6490,1983-05-11,Thomasville,Kansas,29634,300,300,0,11/11/2021 12:06,11/11/2021 12:12
6491,1983-12-20,Thomasville,Kentucky,29634,450,450,0,11/11/2021 12:19,11/20/2021 11:31
6492,1953-02-07,Thomasville,Louisiana,29634,600,600,0,11/11/2021 13:52,1/24/2022 13:32
6493,1983-08-23,Thomasville,Maine,29634,350,350,0,11/11/2021 14:51,11/13/2021 20:09
6494,1991-06-25,Thomasville,Maryland,29634,300,300,0,11/11/2021 14:55,3/12/2022 14:20
6495,1997-03-15,Thomasville,Massachusetts,29634,460,460,0,11/11/2021 14:55,6/25/2022 12:24
6496,1975-09-04,Thomasville,Michigan,29634,300,300,0,11/11/2021 15:27,11/11/2021 15:27
6497,1998-12-19,Thomasville,Minnesota,29634,310,310,0,11/11/2021 16:55,4/11/2022 8:04
6498,1965-09-10,Thomasville,Mississippi,29634,300,300,0,11/11/2021 17:00,3/15/2022 17:38
6499,1968-01-04,Thomasville,Missouri,29634,300,300,0,11/11/2021 17:02,11/13/2021 15:07
6500,2000-05-14,Thomasville,Montana,29634,300,300,0,11/11/2021 17:20,11/13/2021 18:36
6501,1994-04-02,Thomasville,Nebraska,29634,300,300,0,11/11/2021 17:30,11/13/2021 18:56
6502,2004-07-12,Thomasville,Nevada,29634,300,300,0,11/11/2021 18:32,1/22/2022 18:10
6503,1985-02-20,Thomasville,New Hampshire,29634,300,300,0,11/11/2021 21:08,1/2/2022 22:42
6504,2002-06-09,Thomasville,New Jersey,29634,300,300,0,11/11/2021 22:02,12/29/2021 9:41
6505,1961-03-28,Thomasville,New Mexico,29634,300,300,0,11/12/2021 10:10,3/7/2022 23:52
6506,1993-03-27,Thomasville,New York,29634,450,450,0,11/12/2021 11:25,3/1/2022 8:33
6507,1997-06-08,Thomasville,North Carolina,29634,750,750,0,11/12/2021 11:43,11/28/2021 13:01
6508,1993-02-08,Thomasville,North Dakota,29634,400,400,0,11/12/2021 11:46,1/4/2022 17:42
6509,2004-03-14,Thomasville,Ohio,29634,300,300,0,11/12/2021 13:36,11/13/2021 19:33
6510,1959-12-13,Thomasville,Oklahoma,29634,300,300,0,11/12/2021 13:43,1/12/2022 18:41
6511,1961-12-10,Thomasville,Oregon,29634,2460,2460,0,11/12/2021 13:53,5/18/2022 19:56
6512,1979-01-07,Thomasville,Pennsylvania,29634,300,300,0,11/12/2021 14:27,11/12/2021 14:58
6513,1992-07-11,Thomasville,Rhode Island,29634,650,650,0,11/12/2021 14:40,1/22/2022 18:42
6514,1995-04-14,Thomasville,South Carolina,29634,300,300,0,11/12/2021 14:44,1/9/2022 13:20
6515,1988-01-19,Thomasville,South Dakota,29634,360,360,0,11/12/2021 14:44,4/18/2022 10:58
6516,1958-07-10,Thomasville,Tennessee,29634,370,370,0,11/12/2021 14:47,5/11/2022 13:02
6517,1992-10-15,Thomasville,Texas,29634,300,300,0,11/12/2021 14:56,12/2/2021 14:53
6518,1991-03-27,Thomasville,Utah,29634,300,300,0,11/12/2021 15:02,1/18/2022 14:54
6519,1981-02-28,Thomasville,Vermont,29634,400,400,0,11/12/2021 15:38,11/13/2021 17:01
6520,2001-12-23,Thomasville,Virginia,29634,1930,1930,0,11/12/2021 15:59,7/1/2022 4:13
6521,2003-05-10,Thomasville,Washington,29634,350,350,0,11/12/2021 16:16,12/31/2021 11:54
6522,1993-09-03,Thomasville,West Virginia,29634,400,400,0,11/12/2021 16:17,1/22/2022 19:23
6523,1965-08-06,Thomasville,Wisconsin,29634,350,350,0,11/12/2021 17:17,12/11/2021 14:52
6524,1969-07-18,Thomasville,Wyoming,29634,1150,1150,0,11/12/2021 18:06,5/11/2022 18:37
6525,1970-04-04,Thomasville,Alabama,29634,500,500,0,11/12/2021 18:17,3/4/2022 22:15
6526,1964-03-23,Thomasville,Alaska,29634,300,300,0,11/12/2021 18:25,11/12/2021 19:12
6527,1982-02-09,Thomasville,Arizona,29634,310,310,0,11/12/2021 19:36,6/16/2022 17:18
6528,1985-01-23,Thomasville,Arkansas,29634,310,310,0,11/12/2021 19:36,5/7/2022 16:02
6529,1957-07-11,Thomasville,California,29634,1400,1400,0,11/12/2021 19:36,3/27/2022 14:56
6530,2001-09-21,Thomasville,Colorado,29634,1950,1950,0,11/12/2021 19:37,3/25/2022 18:55
6531,1972-06-02,Thomasville,Connecticut,29634,300,300,0,11/12/2021 19:38,3/25/2022 18:00
6532,1969-09-20,Thomasville,Delaware,29634,300,300,0,11/12/2021 19:39,2/26/2022 19:17
6533,1970-07-26,Thomasville,District of Columbia,29634,600,600,0,11/12/2021 19:54,1/17/2022 21:18
6534,1991-02-19,Thomasville,Florida,29634,1000,1000,0,11/12/2021 20:00,3/25/2022 18:27
6535,1976-12-03,Thomasville,Georgia,29634,1210,1210,0,11/12/2021 20:02,3/18/2022 16:57
6536,2000-09-18,Thomasville,Hawaii,29634,460,460,0,11/12/2021 20:42,4/9/2022 10:46
6537,2003-10-07,Thomasville,Idaho,29634,300,300,0,11/12/2021 21:17,12/9/2021 19:43
6538,1988-04-15,Thomasville,Illinois,29634,400,400,0,11/12/2021 21:54,12/3/2021 12:58
6539,1969-07-02,Thomasville,Indiana,29634,310,310,0,11/12/2021 22:03,5/8/2022 9:21
6540,1980-01-17,Thomasville,Iowa,29634,300,300,0,11/12/2021 22:20,1/11/2022 12:42
6541,1950-11-26,Thomasville,Kansas,29634,300,300,0,11/12/2021 22:21,11/23/2021 15:14
6542,1984-10-19,Thomasville,Kentucky,29634,300,300,0,11/12/2021 22:28,11/13/2021 18:28
6543,1985-04-04,Thomasville,Louisiana,29634,300,300,0,11/12/2021 23:12,1/22/2022 18:22
6544,1955-10-06,Thomasville,Maine,29634,300,300,0,11/13/2021 8:47,1/12/2022 19:07
6545,1978-05-13,Thomasville,Maryland,29634,300,300,0,11/13/2021 9:27,11/13/2021 17:54
6546,1971-05-15,Thomasville,Massachusetts,29634,570,570,0,11/13/2021 9:35,4/16/2022 16:54
6547,1980-05-14,Thomasville,Michigan,29634,300,300,0,11/13/2021 9:43,11/14/2021 23:12
6548,2003-02-11,Thomasville,Minnesota,29634,300,300,0,11/13/2021 10:27,11/30/2021 19:23
6549,1973-12-24,Thomasville,Mississippi,29634,300,300,0,11/13/2021 10:32,11/13/2021 18:21
6550,2001-03-15,Thomasville,Missouri,29634,310,310,0,11/13/2021 11:07,4/26/2022 16:51
6551,2005-06-06,Thomasville,Montana,29634,350,350,0,11/13/2021 11:32,1/12/2022 19:37
6552,2001-12-17,Thomasville,Nebraska,29634,410,410,0,11/13/2021 12:05,4/8/2022 15:57
6553,1967-08-20,Thomasville,Nevada,29634,700,700,0,11/13/2021 12:22,6/26/2022 17:07
6554,1990-03-08,Thomasville,New Hampshire,29634,300,300,0,11/13/2021 12:23,12/2/2021 19:08
6555,1996-06-19,Thomasville,New Jersey,29634,300,300,0,11/13/2021 12:23,11/27/2021 18:35
6556,1976-04-26,Thomasville,New Mexico,29634,300,300,0,11/13/2021 12:23,12/28/2021 21:32
6557,1994-11-05,Thomasville,New York,29634,300,300,0,11/13/2021 12:23,11/27/2021 23:00
6558,1986-01-02,Thomasville,North Carolina,29634,320,320,0,11/13/2021 12:33,5/11/2022 13:01
6559,1964-12-20,Thomasville,North Dakota,29634,300,300,0,11/13/2021 12:39,11/22/2021 7:30
6560,1977-01-09,Thomasville,Ohio,29634,350,350,0,11/13/2021 13:04,3/16/2022 9:44
6561,1967-03-11,Thomasville,Oklahoma,29634,300,300,0,11/13/2021 13:05,1/12/2022 11:51
6562,1995-04-26,Thomasville,Oregon,29634,350,350,0,11/13/2021 13:07,12/9/2021 10:35
6563,1950-07-27,Thomasville,Pennsylvania,29634,600,600,0,11/13/2021 13:10,1/21/2022 18:51
6564,1997-07-10,Thomasville,Rhode Island,29634,350,350,0,11/13/2021 13:44,11/29/2021 19:05
6565,1956-04-26,Thomasville,South Carolina,29634,1400,1400,0,11/13/2021 13:59,3/7/2022 15:05
6566,1997-11-30,Winston-Salem ,North Carolina,27101,1410,1410,0,11/13/2021 13:59,4/8/2022 15:51
6566,1997-11-30,Winston-Salem ,North Carolina,27101,1410,1410,0,11/13/2021 13:59,4/8/2022 15:51
6567,1959-08-13,Thomasville,South Dakota,29634,450,450,0,11/13/2021 14:04,12/31/2021 12:59
6568,1965-12-04,Thomasville,Tennessee,29634,300,300,0,11/13/2021 14:04,11/27/2021 20:17
6569,1994-10-23,Thomasville,Texas,29634,300,300,0,11/13/2021 14:17,11/13/2021 14:21
6570,1977-03-14,Thomasville,Utah,29634,300,300,0,11/13/2021 14:20,11/13/2021 19:49
6571,1970-03-05,Thomasville,Vermont,29634,300,300,0,11/13/2021 14:21,1/12/2022 18:44
6572,1995-10-24,Thomasville,Virginia,29634,650,650,0,11/13/2021 14:23,11/13/2021 22:56
6573,1998-12-11,Thomasville,Washington,29634,410,410,0,11/13/2021 14:47,5/29/2022 17:44
6574,2001-11-07,Thomasville,West Virginia,29634,300,300,0,11/13/2021 14:47,11/13/2021 19:38
6575,1995-02-14,Thomasville,Wisconsin,29634,920,920,0,11/13/2021 14:47,6/12/2022 2:03
6576,1993-11-16,Thomasville,Wyoming,29634,300,300,0,11/13/2021 14:49,2/3/2022 12:48
6577,1975-03-12,Thomasville,Alabama,29634,300,300,0,11/13/2021 15:01,11/13/2021 15:02
6578,1990-12-20,Thomasville,Alaska,29634,300,300,0,11/13/2021 15:12,11/13/2021 17:44
6579,1968-09-27,Thomasville,Arizona,29634,320,320,0,11/13/2021 15:21,4/10/2022 10:59
6580,1974-04-15,Thomasville,Arkansas,29634,300,300,0,11/13/2021 15:26,11/13/2021 17:05
6581,1993-12-19,Thomasville,California,29634,300,300,0,11/13/2021 15:30,3/13/2022 9:27
6582,1987-05-16,Thomasville,Colorado,29634,470,470,0,11/13/2021 15:33,6/23/2022 8:10
6583,1980-10-08,Thomasville,Connecticut,29634,650,650,0,11/13/2021 15:39,11/19/2021 18:00
6584,2003-02-22,Thomasville,Delaware,29634,310,310,0,11/13/2021 15:45,4/12/2022 9:47
6585,1983-04-28,Thomasville,District of Columbia,29634,510,510,0,11/13/2021 15:50,4/25/2022 19:24
6586,1999-10-28,Thomasville,Florida,29634,300,300,0,11/13/2021 15:50,11/13/2021 18:41
6587,1971-05-25,Thomasville,Georgia,29634,300,300,0,11/13/2021 15:51,11/13/2021 20:29
6588,1968-02-10,Thomasville,Hawaii,29634,310,310,0,11/13/2021 15:51,4/27/2022 9:00
6589,1994-08-01,Thomasville,Idaho,29634,330,330,0,11/13/2021 15:56,5/11/2022 15:54
6590,1982-04-23,Thomasville,Illinois,29634,400,400,0,11/13/2021 15:58,1/22/2022 19:00
6591,2000-09-08,Thomasville,Indiana,29634,300,300,0,11/13/2021 16:15,3/2/2022 19:55
6592,1997-06-15,Winston-Salem,North Carolina,27106,960,960,0,11/13/2021 16:19,2/19/2022 9:38
6593,1956-08-06,Thomasville,Iowa,29634,300,300,0,11/13/2021 16:35,11/13/2021 16:50
6594,2005-03-11,Thomasville,Kansas,29634,350,350,0,11/13/2021 16:48,2/4/2022 13:41
6595,1996-02-23,Thomasville,Kentucky,29634,1670,1670,0,11/13/2021 17:02,4/15/2022 22:13
6596,1991-12-17,Thomasville,Louisiana,29634,350,350,0,11/13/2021 17:09,11/13/2021 21:09
6597,1953-12-13,Thomasville,Maine,29634,350,350,0,11/13/2021 17:09,11/13/2021 17:39
6598,1965-06-03,Thomasville,Maryland,29634,300,300,0,11/13/2021 17:10,11/13/2021 17:10
6599,1985-08-11,Thomasville,Massachusetts,29634,330,330,0,11/13/2021 17:11,5/15/2022 0:25
6600,1984-08-18,Thomasville,Michigan,29634,360,360,0,11/13/2021 17:26,6/6/2022 8:30
6601,1970-05-09,Thomasville,Minnesota,29634,300,300,0,11/13/2021 17:37,11/13/2021 19:27
6602,1999-10-26,Thomasville,Mississippi,29634,300,300,0,11/13/2021 17:40,2/13/2022 13:32
6603,1994-11-20,Thomasville,Missouri,29634,300,300,0,11/13/2021 17:42,11/19/2021 16:30
6604,1988-01-12,Thomasville,Montana,29634,300,300,0,11/13/2021 17:42,11/13/2021 17:54
6605,1974-03-13,Thomasville,Nebraska,29634,320,320,0,11/13/2021 17:42,4/9/2022 14:10
6606,1960-06-16,Thomasville,Nevada,29634,300,300,0,11/13/2021 17:49,11/13/2021 17:49
6607,1997-06-27,Thomasville,New Hampshire,29634,300,300,0,11/13/2021 17:55,11/13/2021 19:02
6608,1963-04-03,Thomasville,New Jersey,29634,310,310,0,11/13/2021 17:59,5/18/2022 6:31
6609,1952-05-01,Thomasville,New Mexico,29634,300,300,0,11/13/2021 18:01,11/13/2021 18:58
6610,1977-08-11,Thomasville,New York,29634,350,350,0,11/13/2021 18:05,2/3/2022 2:48
6611,1983-01-18,Thomasville,North Carolina,29634,300,300,0,11/13/2021 18:10,11/13/2021 18:11
6612,1951-03-25,Thomasville,North Dakota,29634,770,770,0,11/13/2021 18:25,6/30/2022 17:16
6613,1967-12-26,Thomasville,Ohio,29634,300,300,0,11/13/2021 18:30,3/2/2022 18:41
6614,1955-04-03,Thomasville,Oklahoma,29634,300,300,0,11/13/2021 18:31,1/28/2022 22:06
6615,1978-03-25,Thomasville,Oregon,29634,310,310,0,11/13/2021 18:35,4/19/2022 15:45
6616,1990-10-14,Thomasville,Pennsylvania,29634,300,300,0,11/13/2021 18:44,2/12/2022 10:42
6617,1950-04-07,Thomasville,Rhode Island,29634,350,350,0,11/13/2021 18:47,11/13/2021 19:51
6618,1999-10-25,Thomasville,South Carolina,29634,650,650,0,11/13/2021 18:50,4/1/2022 16:25
6619,2002-01-16,Thomasville,South Dakota,29634,300,300,0,11/13/2021 18:55,11/13/2021 20:26
6620,2002-10-25,Thomasville,Tennessee,29634,350,350,0,11/13/2021 18:55,11/13/2021 19:55
6621,1998-01-21,Thomasville,Texas,29634,300,300,0,11/13/2021 18:57,11/18/2021 14:11
6622,1952-09-12,Thomasville,Utah,29634,360,360,0,11/13/2021 18:57,6/12/2022 0:33
6623,1971-11-01,Thomasville,Vermont,29634,350,350,0,11/13/2021 19:01,11/17/2021 22:02
6624,1991-10-23,Thomasville,Virginia,29634,2540,2540,0,11/13/2021 19:04,7/1/2022 5:39
6625,1981-03-20,Thomasville,Washington,29634,350,350,0,11/13/2021 19:16,11/13/2021 20:22
6626,2001-01-14,Thomasville,West Virginia,29634,1080,1080,0,11/13/2021 19:19,6/17/2022 11:46
6627,1992-01-11,Thomasville,Wisconsin,29634,1100,1100,0,11/13/2021 19:19,3/14/2022 18:13
6628,1998-05-06,Thomasville,Wyoming,29634,350,350,0,11/13/2021 19:23,11/13/2021 21:20
6629,1962-03-27,Thomasville,Alabama,29634,300,300,0,11/13/2021 19:25,11/13/2021 19:25
6630,1951-07-12,Thomasville,Alaska,29634,300,300,0,11/13/2021 19:25,1/12/2022 13:32
6631,1970-01-02,Thomasville,Arizona,29634,550,550,0,11/13/2021 19:26,11/25/2021 11:46
6632,2000-10-08,Thomasville,Arkansas,29634,300,300,0,11/13/2021 19:26,1/12/2022 17:55
6633,1991-02-01,Thomasville,California,29634,300,300,0,11/13/2021 19:37,12/4/2021 23:49
6634,1994-03-02,Thomasville,Colorado,29634,300,300,0,11/13/2021 19:41,11/13/2021 19:45
6635,1983-09-23,Thomasville,Connecticut,29634,300,300,0,11/13/2021 19:50,11/13/2021 20:54
6636,1999-06-28,Thomasville,Delaware,29634,1820,1820,0,11/13/2021 20:14,5/2/2022 10:01
6637,1978-03-21,Thomasville,District of Columbia,29634,300,300,0,11/13/2021 20:24,2/26/2022 19:30
6638,1980-02-21,Thomasville,Florida,29634,950,950,0,11/14/2021 10:34,2/12/2022 15:15
6639,1954-08-21,Thomasville,Georgia,29634,1210,1210,0,11/14/2021 10:55,6/18/2022 11:55
6640,1997-08-19,Thomasville,Hawaii,29634,1440,1440,0,11/14/2021 12:38,3/19/2022 12:07
6641,1956-12-16,Thomasville,Idaho,29634,300,300,0,11/14/2021 13:38,1/22/2022 19:52
6642,1970-10-24,Thomasville,Illinois,29634,300,300,0,11/14/2021 13:47,11/14/2021 13:52
6643,1977-04-15,Thomasville,Indiana,29634,2000,2000,0,11/14/2021 14:21,3/13/2022 13:08
6644,2001-08-22,Thomasville,Iowa,29634,330,330,0,11/16/2021 16:48,6/27/2022 19:11
6645,2001-12-27,Thomasville,Kansas,29634,640,640,0,11/16/2021 17:15,5/26/2022 20:08
6646,1959-08-09,Thomasville,Kentucky,29634,310,310,0,11/16/2021 21:32,5/2/2022 11:08
6647,1970-03-25,Thomasville,Louisiana,29634,600,600,0,11/17/2021 7:51,3/12/2022 19:19
6648,2000-11-02,Thomasville,Maine,29634,300,300,0,11/17/2021 12:44,3/26/2022 13:19
6649,1962-01-04,Thomasville,Maryland,29634,1050,1050,0,11/17/2021 13:34,1/12/2022 19:33
6650,1964-05-01,Thomasville,Massachusetts,29634,450,450,0,11/17/2021 13:35,2/26/2022 23:06
6651,1997-01-31,Thomasville,Michigan,29634,400,400,0,11/17/2021 14:18,3/16/2022 19:01
6652,2004-11-21,Thomasville,Minnesota,29634,1050,1050,0,11/17/2021 14:39,1/13/2022 12:19
6653,1968-09-03,Thomasville,Mississippi,29634,300,300,0,11/17/2021 15:48,11/17/2021 18:51
6654,1951-07-26,Thomasville,Missouri,29634,340,340,0,11/17/2021 15:52,5/11/2022 23:00
6655,1967-06-20,Thomasville,Montana,29634,320,320,0,11/17/2021 18:32,4/13/2022 9:00
6656,1960-09-17,Thomasville,Nebraska,29634,600,600,0,11/17/2021 20:41,2/19/2022 10:21
6657,1998-08-06,Thomasville,Nevada,29634,800,800,0,11/18/2021 12:15,2/26/2022 18:03
6658,1983-12-24,Thomasville,New Hampshire,29634,300,300,0,11/18/2021 15:36,11/18/2021 18:49
6659,1992-07-02,Thomasville,New Jersey,29634,400,400,0,11/18/2021 15:56,3/2/2022 21:50
6660,2001-06-07,Thomasville,New Mexico,29634,1060,1060,0,11/18/2021 16:07,4/15/2022 20:47
6661,1992-02-13,Thomasville,New York,29634,300,300,0,11/18/2021 16:53,3/9/2022 10:48
6662,2000-06-01,Valrico ,Florida,33596,660,660,0,11/18/2021 18:03,5/14/2022 0:43
6663,1988-10-19,Thomasville,North Carolina,29634,300,300,0,11/18/2021 18:50,3/30/2022 17:08
6664,1953-05-23,Thomasville,North Dakota,29634,450,450,0,11/18/2021 21:28,1/26/2022 18:19
6665,1954-01-13,Thomasville,Ohio,29634,610,610,0,11/18/2021 21:28,11/20/2021 18:07
6666,1984-01-10,Thomasville,Oklahoma,29634,300,300,0,11/19/2021 19:54,11/19/2021 19:54
6667,1999-01-06,Thomasville,Oregon,29634,560,560,0,11/20/2021 1:06,6/22/2022 22:22
6668,1986-09-14,Thomasville,Pennsylvania,29634,300,300,0,11/20/2021 12:44,11/20/2021 16:03
6669,1998-09-09,Thomasville,Rhode Island,29634,1810,1810,0,11/23/2021 19:20,4/16/2022 12:40
6670,1989-11-19,Thomasville,South Carolina,29634,1110,1110,0,11/23/2021 19:56,4/16/2022 13:57
6671,1976-04-14,Thomasville,South Dakota,29634,610,610,0,11/23/2021 19:58,4/9/2022 13:26
6672,1979-01-10,Thomasville,Tennessee,29634,300,300,0,11/23/2021 19:58,3/2/2022 18:53
6673,1997-03-17,Thomasville,Texas,29634,300,300,0,11/23/2021 19:59,3/2/2022 11:01
6674,1988-01-25,Thomasville,Utah,29634,700,700,0,11/23/2021 20:08,3/17/2022 2:01
6675,2000-12-11,Thomasville,Vermont,29634,400,400,0,11/23/2021 20:10,2/19/2022 11:53
6676,1968-03-26,Thomasville,Virginia,29634,300,300,0,11/23/2021 20:10,1/12/2022 18:47
6677,1957-01-24,Thomasville,Washington,29634,450,450,0,11/23/2021 20:10,2/26/2022 16:13
6678,1981-01-06,Thomasville,West Virginia,29634,320,320,0,11/23/2021 20:15,6/23/2022 13:02
6679,1965-08-22,Thomasville,Wisconsin,29634,450,450,0,11/23/2021 20:53,11/23/2021 20:55
6680,1998-01-10,Thomasville,Wyoming,29634,4020,5520,1500,11/23/2021 20:54,6/6/2022 16:28
6681,1975-10-09,Thomasville,Alabama,29634,950,2450,1500,11/23/2021 21:17,2/12/2022 14:45
6682,1998-04-04,Thomasville,Alaska,29634,13030,13030,0,11/24/2021 13:45,6/10/2022 9:44
6683,1994-07-11,Clovis,New Mexico,88101,410,410,0,11/27/2021 14:56,5/16/2022 8:57
6684,1975-04-20,Thomasville,Arizona,29634,300,300,0,11/27/2021 16:11,12/1/2021 16:33
6685,2004-03-13,Thomasville,Arkansas,29634,600,600,0,11/27/2021 16:21,1/25/2022 19:00
6686,1979-10-07,Thomasville,California,29634,600,600,0,11/27/2021 16:56,3/14/2022 10:09
6687,1952-12-15,Thomasville,Colorado,29634,300,300,0,11/27/2021 17:03,1/22/2022 18:28
6688,1976-01-07,Thomasville,Connecticut,29634,300,300,0,11/27/2021 17:06,11/27/2021 20:26
6689,1994-09-04,Thomasville,Delaware,29634,300,300,0,11/27/2021 17:08,3/11/2022 8:52
6690,2000-10-17,Thomasville,District of Columbia,29634,750,750,0,11/27/2021 17:08,3/2/2022 9:37
6691,1979-03-28,Thomasville,Florida,29634,420,420,0,11/27/2021 17:08,5/8/2022 9:21
6692,1964-05-08,Thomasville,Georgia,29634,800,800,0,11/27/2021 17:46,3/7/2022 18:07
6693,1966-09-26,Thomasville,Hawaii,29634,900,900,0,11/27/2021 17:53,3/2/2022 20:02
6694,1952-06-05,Thomasville,Idaho,29634,300,300,0,11/27/2021 18:26,1/12/2022 10:26
6695,1972-02-26,Thomasville,Illinois,29634,320,320,0,11/27/2021 18:46,5/10/2022 18:00
6696,1964-06-12,Thomasville,Indiana,29634,320,320,0,11/27/2021 19:10,6/22/2022 9:00
6697,2000-10-14,Thomasville,Iowa,29634,300,300,0,11/27/2021 19:37,2/27/2022 11:01
6698,1974-09-02,Thomasville,Kansas,29634,300,300,0,11/27/2021 19:39,11/27/2021 19:39
6699,1998-05-12,Thomasville,Kentucky,29634,400,400,0,11/27/2021 19:48,2/3/2022 19:22
6700,1993-06-07,Thomasville,Louisiana,29634,310,310,0,11/27/2021 19:51,5/29/2022 20:40
6701,1964-04-06,Thomasville,Maine,29634,300,300,0,11/27/2021 20:00,1/22/2022 19:28
6702,1976-10-11,Thomasville,Maryland,29634,600,600,0,11/27/2021 20:02,3/1/2022 13:19
6703,1990-01-25,Thomasville,Massachusetts,29634,300,300,0,11/27/2021 20:09,3/16/2022 9:36
6704,1973-09-01,Thomasville,Michigan,29634,300,300,0,11/27/2021 20:27,11/27/2021 20:27
6705,1977-02-23,Thomasville,Minnesota,29634,300,300,0,11/27/2021 22:42,1/22/2022 17:35
6706,1972-08-13,Thomasville,Mississippi,29634,2570,2570,0,11/27/2021 22:49,5/11/2022 20:49
6707,1987-04-27,Maple Grove,Minnesota,55311,400,400,0,11/28/2021 20:14,12/3/2021 19:06
6708,1964-12-17,Thomasville,Missouri,29634,400,400,0,11/29/2021 21:07,2/26/2022 18:12
6709,1971-08-08,Thomasville,Montana,29634,300,300,0,11/30/2021 6:44,11/30/2021 6:51
6710,1952-01-16,Thomasville,Nebraska,29634,0,300,500,11/30/2021 12:40,12/9/2021 10:23
6711,1988-04-28,Thomasville,Nevada,29634,200,200,0,11/30/2021 15:35,11/30/2021 15:39
6712,2003-01-04,Thomasville,New Hampshire,29634,100,400,500,11/30/2021 17:36,11/30/2021 21:40
6713,1983-10-27,Thomasville,New Jersey,29634,300,300,0,11/30/2021 18:13,11/30/2021 18:15
6714,1983-08-26,Thomasville,New Mexico,29634,300,300,0,11/30/2021 18:16,11/30/2021 18:20
6715,1958-07-17,Thomasville,New York,29634,300,300,0,11/30/2021 18:18,11/30/2021 18:20
6716,1980-07-28,Thomasville,North Carolina,29634,1100,1100,0,11/30/2021 18:23,5/23/2022 10:55
6717,2003-08-08,Thomasville,North Dakota,29634,700,700,0,11/30/2021 18:28,1/12/2022 17:38
6718,2005-03-13,Thomasville,Ohio,29634,600,600,0,11/30/2021 18:30,12/4/2021 22:09
6719,1992-06-15,Thomasville,Oklahoma,29634,300,300,0,11/30/2021 18:38,1/4/2022 22:33
6720,1988-10-27,Thomasville,Oregon,29634,400,400,0,11/30/2021 18:45,1/22/2022 18:00
6721,1978-03-21,Thomasville,Pennsylvania,29634,510,510,0,11/30/2021 18:52,4/19/2022 17:33
6722,1976-11-05,Thomasville,Rhode Island,29634,300,300,0,11/30/2021 19:24,11/30/2021 19:27
6723,1985-08-01,Thomasville,South Carolina,29634,750,750,0,11/30/2021 20:53,12/2/2021 16:08
6724,1995-11-11,Thomasville,South Dakota,29634,1450,1450,0,11/30/2021 20:54,2/12/2022 15:42
6725,1955-09-11,Thomasville,Tennessee,29634,300,300,0,11/30/2021 21:01,2/9/2022 9:00
6726,1951-02-26,Thomasville,Texas,29634,300,300,0,11/30/2021 21:15,2/22/2022 10:06
6727,1997-09-09,Thomasville,Utah,29634,400,400,0,11/30/2021 23:17,12/1/2021 19:33
6728,1963-05-16,Thomasville,Vermont,29634,300,300,0,11/30/2021 23:56,1/12/2022 16:27
6729,1995-11-29,Thomasville,Virginia,29634,1150,1150,0,12/1/2021 9:40,6/29/2022 13:47
6730,1997-10-11,Smithtown,New York,11787,400,400,0,12/1/2021 10:23,12/2/2021 21:37
6731,1994-09-12,Thomasville,Washington,29634,50,300,500,12/1/2021 13:10,12/4/2021 12:32
6732,1982-01-08,Thomasville,West Virginia,29634,300,300,0,12/1/2021 15:42,3/13/2022 10:34
6733,1960-05-28,Thomasville,Wisconsin,29634,300,300,0,12/1/2021 16:20,12/1/2021 16:20
6734,1998-10-18,Thomasville,Wyoming,29634,2280,3280,1000,12/1/2021 17:54,4/16/2022 9:06
6735,1950-12-03,Thomasville,Alabama,29634,600,600,0,12/1/2021 23:01,3/22/2022 9:56
6736,1988-02-24,Thomasville,Alaska,29634,460,460,0,12/2/2021 9:03,12/4/2021 19:19
6737,1999-09-08,Thomasville,Arizona,29634,300,300,0,12/3/2021 8:54,1/30/2022 13:19
6738,1969-10-26,Thomasville,Arkansas,29634,2470,2470,0,12/8/2021 11:44,4/9/2022 18:22
6739,2021-09-06,Thomasville,California,29634,3570,3570,0,12/8/2021 11:44,4/15/2022 12:28
6740,2000-03-08,Thomasville,Colorado,29634,650,650,0,12/9/2021 10:50,3/25/2022 18:56
6741,1965-07-05,Thomasville,Connecticut,29634,300,300,0,12/10/2021 20:55,12/11/2021 23:09
6742,1994-05-10,Thomasville,Delaware,29634,840,840,0,12/11/2021 16:26,5/10/2022 23:04
6743,1951-12-13,Thomasville,District of Columbia,29634,300,300,0,12/11/2021 17:03,1/11/2022 15:43
6744,1978-10-27,Thomasville,Florida,29634,860,860,0,12/11/2021 17:48,4/19/2022 18:00
6745,1974-02-23,Thomasville,Georgia,29634,320,320,0,12/11/2021 17:48,5/8/2022 9:42
6746,1952-12-08,Thomasville,Hawaii,29634,750,750,0,12/11/2021 17:49,2/3/2022 12:09
6747,1990-10-07,Thomasville,Idaho,29634,850,850,0,12/11/2021 17:53,2/12/2022 14:16
6748,1972-05-17,Thomasville,Illinois,29634,850,850,0,12/11/2021 17:53,4/1/2022 21:38
6749,1983-01-20,Thomasville,Indiana,29634,450,450,0,12/11/2021 18:10,3/5/2022 14:44
6750,1977-03-19,Thomasville,Iowa,29634,300,300,0,12/11/2021 18:27,1/10/2022 13:50
6751,1989-05-05,Thomasville,Kansas,29634,3900,3900,0,12/11/2021 18:36,3/24/2022 20:19
6752,1966-12-05,Thomasville,Kentucky,29634,450,450,0,12/11/2021 18:38,1/10/2022 9:03
6753,2003-04-22,Thomasville,Louisiana,29634,910,910,0,12/11/2021 18:39,5/4/2022 12:03
6754,1972-04-20,Thomasville,Maine,29634,300,300,0,12/11/2021 19:00,1/18/2022 22:04
6755,1991-07-12,Thomasville,Maryland,29634,300,300,0,12/11/2021 22:01,3/20/2022 15:45
6756,1993-01-27,Thomasville,Massachusetts,29634,610,610,0,12/12/2021 3:26,4/29/2022 23:12
6757,1966-01-16,Thomasville,Michigan,29634,310,310,0,12/18/2021 13:36,4/9/2022 14:22
6758,1977-05-11,Thomasville,Minnesota,29634,310,310,0,12/22/2021 21:30,5/18/2022 11:14
6759,1950-06-12,Thomasville,Mississippi,29634,600,600,0,12/26/2021 17:47,3/28/2022 2:28
6760,2003-03-14,Thomasville,Missouri,29634,300,300,0,12/30/2021 12:54,4/6/2022 6:58
6761,1976-07-18,Thomasville,Montana,29634,300,300,0,12/30/2021 20:50,1/19/2022 18:30
6762,1961-01-28,Thomasville,Nebraska,29634,300,300,0,1/2/2022 18:41,3/30/2022 18:07
6763,2000-02-03,Thomasville,Nevada,29634,750,750,0,1/4/2022 11:57,2/22/2022 19:30
6764,1981-01-05,Thomasville,New Hampshire,29634,450,450,0,1/4/2022 17:38,4/6/2022 9:23
6765,2000-12-29,Thomasville,New Jersey,29634,1270,1270,0,1/5/2022 15:43,5/8/2022 10:46
6766,1987-03-02,Thomasville,New Mexico,29634,400,400,0,1/5/2022 19:34,1/14/2022 0:33
6767,2004-10-23,Thomasville,New York,29634,330,330,0,1/6/2022 17:38,5/7/2022 15:15
6768,1976-09-18,Thomasville,North Carolina,29634,810,810,0,1/6/2022 17:45,5/3/2022 17:41
6769,2001-02-14,Thomasville,North Dakota,29634,1850,1850,0,1/7/2022 14:23,5/25/2022 22:43
6770,1995-11-17,Winston-Salem,North Carolina,27103,420,420,0,1/7/2022 15:14,5/6/2022 11:53
6771,1991-01-18,Thomasville,Ohio,29634,410,410,0,1/7/2022 19:27,1/31/2022 16:20
6772,1975-03-17,Thomasville,Oklahoma,29634,450,450,0,1/7/2022 19:28,1/8/2022 13:47
6773,1987-01-10,Thomasville,Oregon,29634,400,400,0,1/7/2022 19:28,3/8/2022 14:26
6774,1993-03-17,Thomasville,Pennsylvania,29634,700,700,0,1/7/2022 19:28,2/9/2022 16:17
6775,1959-04-20,Thomasville,Rhode Island,29634,300,300,0,1/7/2022 19:29,1/8/2022 13:43
6776,2003-11-10,Thomasville,South Carolina,29634,300,300,0,1/7/2022 19:30,1/8/2022 13:41
6777,1982-09-09,Thomasville,South Dakota,29634,420,420,0,1/7/2022 19:42,4/16/2022 14:23
6778,1954-02-09,Thomasville,Tennessee,29634,450,450,0,1/7/2022 21:17,1/8/2022 13:54
6779,1960-05-03,Thomasville,Texas,29634,300,300,0,1/7/2022 22:46,3/2/2022 9:22
6780,1967-04-13,Thomasville,Utah,29634,560,560,0,1/7/2022 22:46,4/16/2022 16:31
6781,1971-04-30,Charlotte ,North Carolina,28216,400,400,0,1/7/2022 22:50,2/3/2022 19:42
6782,1952-01-15,Thomasville,Vermont,29634,300,300,0,1/8/2022 7:31,1/8/2022 13:50
6783,1993-07-13,Thomasville,Virginia,29634,300,300,0,1/8/2022 7:34,1/10/2022 19:51
6784,1985-11-19,Thomasville,Washington,29634,970,970,0,1/8/2022 7:35,6/29/2022 18:39
6785,1972-12-26,Thomasville,West Virginia,29634,320,320,0,1/8/2022 7:35,6/19/2022 14:44
6786,1977-11-16,Thomasville,Wisconsin,29634,550,550,0,1/8/2022 7:43,2/2/2022 21:29
6787,1995-09-03,Thomasville,Wyoming,29634,310,310,0,1/8/2022 8:37,5/6/2022 13:17
6788,1992-01-17,Thomasville,Alabama,29634,310,310,0,1/8/2022 8:46,5/2/2022 18:00
6789,1950-04-14,Thomasville,Alaska,29634,300,300,0,1/8/2022 9:46,1/8/2022 13:38
6790,1958-06-06,Thomasville,Arizona,29634,450,450,0,1/8/2022 9:52,1/8/2022 16:01
6791,1973-01-16,Thomasville,Arkansas,29634,300,300,0,1/8/2022 10:17,3/2/2022 2:10
6792,1996-08-26,Thomasville,California,29634,970,970,0,1/8/2022 10:28,5/16/2022 9:19
6793,1992-10-15,Thomasville,Colorado,29634,710,710,0,1/8/2022 11:18,2/9/2022 9:08
6794,2003-01-24,Thomasville,Connecticut,29634,1150,1150,0,1/8/2022 12:18,3/25/2022 18:14
6795,1954-11-20,Thomasville,Delaware,29634,300,300,0,1/8/2022 12:19,3/25/2022 17:52
6796,1995-12-31,Thomasville,District of Columbia,29634,560,560,0,1/8/2022 13:16,1/19/2022 12:23
6797,1977-05-11,Thomasville,Florida,29634,300,300,0,1/8/2022 13:17,1/15/2022 9:28
6798,1984-11-11,Thomasville,Georgia,29634,320,320,0,1/8/2022 13:33,4/29/2022 16:04
6799,1992-02-05,Thomasville,Hawaii,29634,310,310,0,1/8/2022 16:18,4/18/2022 18:13
6800,1978-11-07,Thomasville,Idaho,29634,1200,1200,0,1/8/2022 19:56,5/11/2022 20:36
6801,1985-06-06,Thomasville,Illinois,29634,320,320,0,1/8/2022 19:56,4/15/2022 13:34
6802,1950-01-03,Thomasville,Indiana,29634,300,300,0,1/8/2022 19:56,2/26/2022 16:19
6803,1983-12-06,Thomasville,Iowa,29634,600,600,0,1/8/2022 19:57,2/26/2022 18:25
6804,2004-08-09,Thomasville,Kansas,29634,600,600,0,1/8/2022 19:59,3/10/2022 10:34
6805,2003-02-23,Thomasville,Kentucky,29634,300,300,0,1/8/2022 20:00,2/24/2022 12:37
6806,1987-01-24,Thomasville,Louisiana,29634,300,300,0,1/8/2022 20:02,3/7/2022 19:09
6807,2000-06-01,Thomasville,Maine,29634,400,400,0,1/8/2022 22:05,3/8/2022 19:44
6808,1991-03-08,Thomasville,Maryland,29634,700,700,0,1/9/2022 12:01,1/21/2022 17:09
6809,2005-09-25,Thomasville,Massachusetts,29634,410,410,0,1/9/2022 14:00,5/11/2022 13:14
6810,1959-06-27,Thomasville,Michigan,29634,310,310,0,1/9/2022 14:13,4/8/2022 21:52
6811,1990-10-12,Thomasville,Minnesota,29634,320,320,0,1/9/2022 14:13,5/2/2022 10:01
6812,1956-03-08,Thomasville,Mississippi,29634,300,300,0,1/9/2022 14:14,2/2/2022 10:40
6813,1990-02-08,Thomasville,Missouri,29634,760,760,0,1/9/2022 14:30,6/25/2022 8:45
6814,2000-07-21,Thomasville,Montana,29634,2450,4450,2000,1/9/2022 18:17,4/27/2022 8:34
6815,1958-09-02,Thomasville,Nebraska,29634,1610,1610,0,1/9/2022 20:55,4/19/2022 13:16
6816,1983-12-15,Thomasville,Nevada,29634,370,370,0,1/9/2022 23:10,5/26/2022 17:27
6817,1954-02-14,Thomasville,New Hampshire,29634,600,600,0,1/10/2022 9:07,2/12/2022 14:59
6818,2001-05-25,Thomasville,New Jersey,29634,400,400,0,1/10/2022 9:07,3/9/2022 20:18
6819,1976-04-19,Thomasville,New Mexico,29634,310,310,0,1/10/2022 9:11,4/16/2022 16:44
6820,2000-03-19,Thomasville,New York,29634,310,310,0,1/10/2022 9:16,4/11/2022 14:02
6821,1955-01-24,Thomasville,North Carolina,29634,300,300,0,1/10/2022 9:16,1/24/2022 17:09
6822,1981-12-09,Thomasville,North Dakota,29634,850,850,0,1/10/2022 9:20,3/28/2022 16:31
6823,1985-01-13,Thomasville,Ohio,29634,1950,1950,0,1/10/2022 9:20,3/30/2022 17:07
6824,1959-09-05,Thomasville,Oklahoma,29634,300,300,0,1/10/2022 9:22,1/23/2022 1:16
6825,2001-05-30,Cleveland,North Carolina,27013,400,400,0,1/10/2022 9:24,2/28/2022 17:30
6826,1980-10-26,Thomasville,Oregon,29634,300,300,0,1/10/2022 9:27,1/13/2022 12:19
6827,1958-09-06,Thomasville,Pennsylvania,29634,300,300,0,1/10/2022 9:30,1/12/2022 18:28
6828,1986-03-05,Thomasville,Rhode Island,29634,600,600,0,1/10/2022 9:41,3/2/2022 13:42
6829,1962-09-12,Thomasville,South Carolina,29634,620,620,0,1/10/2022 9:41,5/4/2022 9:00
6830,1990-08-03,Thomasville,South Dakota,29634,300,300,0,1/10/2022 9:43,1/13/2022 7:41
6831,1966-04-05,Thomasville,Tennessee,29634,300,300,0,1/10/2022 9:57,3/2/2022 20:35
6832,1973-09-13,Thomasville,Texas,29634,600,600,0,1/10/2022 9:59,2/19/2022 12:46
6833,1962-02-09,Thomasville,Utah,29634,300,300,0,1/10/2022 10:05,2/26/2022 18:51
6834,2000-07-12,Thomasville,Vermont,29634,950,950,0,1/10/2022 10:06,3/30/2022 18:04
6835,2004-04-13,Thomasville,Virginia,29634,310,310,0,1/10/2022 10:09,4/15/2022 14:03
6836,1958-08-09,Thomasville,Washington,29634,300,300,0,1/10/2022 10:11,3/14/2022 17:43
6837,2004-04-24,Thomasville,West Virginia,29634,300,300,0,1/10/2022 10:19,2/26/2022 10:09
6838,1967-05-21,Thomasville,Wisconsin,29634,300,300,0,1/10/2022 10:32,3/23/2022 14:06
6839,1970-10-06,Thomasville,Wyoming,29634,400,400,0,1/10/2022 10:32,2/26/2022 15:27
6840,1961-11-19,Thomasville,Alabama,29634,600,600,0,1/10/2022 10:33,1/22/2022 16:05
6841,1993-05-14,Thomasville,Alaska,29634,300,300,0,1/10/2022 10:44,1/18/2022 14:57
6842,1987-11-19,Thomasville,Arizona,29634,1040,1040,0,1/10/2022 10:44,5/24/2022 11:25
6843,1959-07-22,Thomasville,Arkansas,29634,300,300,0,1/10/2022 10:44,3/2/2022 15:39
6844,1993-12-03,Thomasville,California,29634,610,610,0,1/10/2022 10:51,5/8/2022 14:38
6845,1977-01-27,Thomasville,Colorado,29634,1100,1100,0,1/10/2022 10:55,3/25/2022 18:55
6846,1957-10-15,Thomasville,Connecticut,29634,560,560,0,1/10/2022 11:01,4/16/2022 15:39
6847,1982-12-07,Thomasville,Delaware,29634,300,300,0,1/10/2022 11:13,2/28/2022 12:12
6848,1997-05-07,Thomasville,District of Columbia,29634,300,300,0,1/10/2022 11:19,3/23/2022 9:23
6849,1960-08-21,Thomasville,Florida,29634,760,760,0,1/10/2022 11:35,1/12/2022 19:52
6850,1963-06-27,Thomasville,Georgia,29634,760,760,0,1/10/2022 11:41,1/22/2022 13:13
6851,1972-12-16,Thomasville,Hawaii,29634,760,760,0,1/10/2022 11:43,3/4/2022 18:55
6852,1997-01-01,Thomasville,Idaho,29634,800,800,0,1/10/2022 11:44,2/26/2022 19:30
6853,1986-06-11,Thomasville,Illinois,29634,500,500,0,1/10/2022 11:45,2/19/2022 12:32
6854,2003-06-27,Thomasville,Indiana,29634,400,400,0,1/10/2022 11:51,1/22/2022 18:54
6855,1971-03-22,Thomasville,Iowa,29634,750,750,0,1/10/2022 11:53,3/25/2022 18:15
6856,1990-01-09,Thomasville,Kansas,29634,300,300,0,1/10/2022 11:58,3/31/2022 17:51
6857,1954-12-06,Thomasville,Kentucky,29634,300,300,0,1/10/2022 12:00,1/10/2022 12:00
6858,1963-11-22,Thomasville,Louisiana,29634,300,300,0,1/10/2022 12:04,1/30/2022 10:43
6859,1991-05-21,Thomasville,Maine,29634,400,400,0,1/10/2022 12:08,3/30/2022 0:28
6860,1988-04-06,Thomasville,Maryland,29634,300,300,0,1/10/2022 12:29,1/12/2022 18:16
6861,1964-02-23,Thomasville,Massachusetts,29634,300,300,0,1/10/2022 12:30,2/26/2022 17:38
6862,1979-08-02,Thomasville,Michigan,29634,300,300,0,1/10/2022 12:45,3/22/2022 20:18
6863,1995-11-14,Thomasville,Minnesota,29634,400,400,0,1/10/2022 12:49,2/17/2022 13:09
6864,1969-10-20,Thomasville,Mississippi,29634,300,300,0,1/10/2022 13:22,2/24/2022 19:33
6865,1952-12-26,Thomasville,Missouri,29634,600,600,0,1/10/2022 13:28,3/24/2022 18:00
6866,1996-09-15,Thomasville,Montana,29634,800,800,0,1/10/2022 13:43,2/19/2022 13:24
6867,1967-04-16,Thomasville,Nebraska,29634,300,300,0,1/10/2022 13:47,1/12/2022 16:13
6868,2003-11-10,Thomasville,Nevada,29634,320,320,0,1/10/2022 13:55,6/24/2022 11:08
6869,1989-07-12,Thomasville,New Hampshire,29634,320,320,0,1/10/2022 14:06,5/26/2022 20:34
6870,1996-03-26,Thomasville,New Jersey,29634,300,300,0,1/10/2022 14:13,3/25/2022 17:38
6871,1982-11-02,Thomasville,New Mexico,29634,600,600,0,1/10/2022 14:51,3/2/2022 15:01
6872,1996-06-04,Thomasville,New York,29634,300,300,0,1/10/2022 14:56,3/19/2022 14:01
6873,1964-07-27,Thomasville,North Carolina,29634,300,300,0,1/10/2022 15:25,3/4/2022 3:09
6874,1987-09-03,Thomasville,North Dakota,29634,1500,1500,0,1/10/2022 15:27,3/15/2022 18:35
6875,1998-10-13,Thomasville,Ohio,29634,300,300,0,1/10/2022 15:30,1/12/2022 17:15
6876,1971-05-13,Thomasville,Oklahoma,29634,300,300,0,1/10/2022 15:40,2/11/2022 16:09
6877,1983-06-18,Thomasville,Oregon,29634,320,320,0,1/10/2022 15:41,4/28/2022 12:08
6878,2000-09-20,Thomasville,Pennsylvania,29634,400,400,0,1/10/2022 15:41,1/22/2022 18:57
6879,1951-12-24,Thomasville,Rhode Island,29634,510,510,0,1/10/2022 15:50,5/3/2022 17:55
6880,1991-08-27,Thomasville,South Carolina,29634,730,730,0,1/10/2022 16:07,6/28/2022 18:14
6881,2004-08-10,Thomasville,South Dakota,29634,600,600,0,1/10/2022 16:20,2/28/2022 21:44
6882,1972-12-23,Thomasville,Tennessee,29634,300,300,0,1/10/2022 16:21,3/25/2022 20:32
6883,1961-05-10,Thomasville,Texas,29634,810,810,0,1/10/2022 16:29,5/26/2022 20:06
6884,1994-06-02,Thomasville,Utah,29634,310,310,0,1/10/2022 16:40,4/10/2022 9:35
6885,2002-01-17,Thomasville,Vermont,29634,300,300,0,1/10/2022 16:47,2/22/2022 15:34
6886,1997-11-20,Thomasville,Virginia,29634,310,310,0,1/10/2022 17:04,4/19/2022 17:42
6887,1993-07-23,Thomasville,Washington,29634,600,600,0,1/10/2022 17:22,1/24/2022 18:07
6888,1957-02-01,Thomasville,West Virginia,29634,1110,1110,0,1/10/2022 17:35,4/15/2022 20:50
6889,1998-06-02,Thomasville,Wisconsin,29634,750,750,0,1/10/2022 17:37,1/13/2022 20:01
6890,1959-11-11,Thomasville,Wyoming,29634,300,300,0,1/10/2022 17:42,3/2/2022 21:02
6891,1977-08-11,Thomasville,Alabama,29634,300,300,0,1/10/2022 17:49,2/26/2022 18:57
6892,1981-05-14,Thomasville,Alaska,29634,300,300,0,1/10/2022 17:53,1/17/2022 22:10
6893,2002-11-16,Thomasville,Arizona,29634,310,310,0,1/10/2022 18:02,2/11/2022 22:44
6894,2004-12-23,Thomasville,Arkansas,29634,400,400,0,1/10/2022 18:06,3/14/2022 15:04
6895,1998-12-02,Thomasville,California,29634,400,400,0,1/10/2022 18:08,1/19/2022 16:25
6896,1981-07-23,Thomasville,Colorado,29634,300,300,0,1/10/2022 18:12,2/12/2022 12:51
6897,1962-03-21,Thomasville,Connecticut,29634,850,850,0,1/10/2022 18:23,3/2/2022 20:57
6898,1950-05-20,Thomasville,Delaware,29634,300,300,0,1/10/2022 18:24,1/12/2022 17:39
6899,1998-11-05,Thomasville,District of Columbia,29634,600,600,0,1/10/2022 18:28,3/13/2022 22:59
6900,2003-03-25,Thomasville,Florida,29634,2110,2110,0,1/10/2022 18:34,4/8/2022 19:37
6901,2003-01-24,Thomasville,Georgia,29634,300,300,0,1/10/2022 18:49,1/12/2022 15:47
6902,1994-02-26,Thomasville,Hawaii,29634,300,300,0,1/10/2022 19:05,1/12/2022 17:49
6903,1955-11-03,Thomasville,Idaho,29634,400,400,0,1/10/2022 19:22,2/26/2022 18:09
6904,1961-06-05,Thomasville,Illinois,29634,600,600,0,1/10/2022 19:33,3/16/2022 11:57
6905,1996-04-17,Thomasville,Indiana,29634,850,850,0,1/10/2022 19:35,1/13/2022 12:19
6906,1997-02-10,Thomasville,Iowa,29634,950,950,0,1/10/2022 19:36,2/12/2022 15:12
6907,1960-05-24,Thomasville,Kansas,29634,300,300,0,1/10/2022 19:52,1/22/2022 21:59
6908,1951-06-17,Thomasville,Kentucky,29634,300,300,0,1/10/2022 19:57,3/16/2022 19:30
6909,2003-04-02,Thomasville,Louisiana,29634,300,300,0,1/10/2022 20:04,1/12/2022 15:07
6910,1974-09-18,Thomasville,Maine,29634,1010,1010,0,1/10/2022 20:08,4/19/2022 18:12
6911,1978-12-10,Thomasville,Maryland,29634,300,300,0,1/10/2022 20:16,3/2/2022 20:46
6912,1998-12-10,Thomasville,Massachusetts,29634,320,320,0,1/10/2022 20:32,4/28/2022 20:50
6913,1999-06-04,Thomasville,Michigan,29634,310,310,0,1/10/2022 20:32,4/27/2022 9:00
6914,2003-03-12,Thomasville,Minnesota,29634,300,300,0,1/10/2022 20:42,3/2/2022 20:51
6915,1981-07-23,Thomasville,Mississippi,29634,300,300,0,1/10/2022 21:19,1/22/2022 19:26
6916,1989-12-03,Thomasville,Missouri,29634,850,850,0,1/10/2022 21:55,3/25/2022 18:12
6917,1997-03-03,Thomasville,Montana,29634,510,510,0,1/10/2022 22:05,5/9/2022 18:00
6918,1967-02-24,Thomasville,Nebraska,29634,300,300,0,1/10/2022 22:26,2/4/2022 22:35
6919,1952-10-20,Thomasville,Nevada,29634,750,750,0,1/10/2022 23:18,2/19/2022 12:45
6920,1987-06-24,Thomasville,New Hampshire,29634,300,300,0,1/10/2022 23:26,1/12/2022 8:11
6921,1966-05-10,Thomasville,New Jersey,29634,600,600,0,1/10/2022 23:28,2/26/2022 14:38
6922,1961-05-06,Thomasville,New Mexico,29634,600,600,0,1/10/2022 23:53,1/13/2022 15:40
6923,1956-04-10,Thomasville,New York,29634,600,600,0,1/11/2022 2:02,2/28/2022 10:38
6924,2001-02-06,Thomasville,North Carolina,29634,410,410,0,1/11/2022 2:55,5/6/2022 16:36
6925,1997-07-14,Thomasville,North Dakota,29634,870,870,0,1/11/2022 9:36,5/4/2022 9:00
6926,1958-11-09,Thomasville,Ohio,29634,600,600,0,1/11/2022 9:54,3/19/2022 16:40
6927,1977-11-06,Thomasville,Oklahoma,29634,310,310,0,1/11/2022 10:01,4/18/2022 12:55
6928,1967-04-08,Thomasville,Oregon,29634,900,900,0,1/11/2022 10:04,3/17/2022 18:55
6929,1954-08-13,Thomasville,Pennsylvania,29634,550,550,0,1/11/2022 10:49,3/26/2022 17:46
6930,1985-04-14,Thomasville,Rhode Island,29634,300,300,0,1/11/2022 10:59,2/3/2022 17:51
6931,1998-07-19,Thomasville,South Carolina,29634,550,550,0,1/11/2022 11:07,6/27/2022 16:21
6932,1966-11-02,Thomasville,South Dakota,29634,300,300,0,1/11/2022 11:09,1/17/2022 23:59
6933,2000-10-05,Thomasville,Tennessee,29634,400,400,0,1/11/2022 12:05,3/19/2022 14:12
6934,1989-08-11,Thomasville,Texas,29634,300,300,0,1/11/2022 12:11,1/11/2022 12:59
6935,1959-10-12,Thomasville,Utah,29634,330,330,0,1/11/2022 12:31,5/25/2022 12:16
6936,1999-01-19,Thomasville,Vermont,29634,400,400,0,1/11/2022 13:01,1/24/2022 11:55
6937,1999-09-10,Thomasville,Virginia,29634,380,380,0,1/11/2022 13:04,6/10/2022 9:34
6938,2004-01-09,Thomasville,Washington,29634,2100,2100,0,1/11/2022 13:11,4/22/2022 16:23
6939,1980-08-15,Thomasville,West Virginia,29634,300,300,0,1/11/2022 13:23,3/22/2022 17:39
6940,1990-12-11,Thomasville,Wisconsin,29634,750,750,0,1/11/2022 14:29,2/2/2022 19:31
6941,1978-01-23,Thomasville,Wyoming,29634,1330,1330,0,1/11/2022 14:30,5/3/2022 17:45
6942,1975-11-25,Thomasville,Alabama,29634,600,600,0,1/11/2022 14:44,1/12/2022 18:53
6943,2000-01-09,Thomasville,Alaska,29634,1150,1150,0,1/11/2022 14:57,3/2/2022 20:27
6944,1991-08-20,Thomasville,Arizona,29634,300,300,0,1/11/2022 15:05,1/11/2022 15:07
6945,1987-10-18,Thomasville,Arkansas,29634,300,300,0,1/11/2022 15:13,1/12/2022 19:26
6946,2004-03-24,Thomasville,California,29634,1290,1290,0,1/11/2022 15:16,5/3/2022 18:06
6947,2001-05-09,Thomasville,Colorado,29634,700,700,0,1/11/2022 15:24,2/26/2022 16:59
6948,1960-08-14,Thomasville,Connecticut,29634,1760,1760,0,1/11/2022 15:25,4/9/2022 19:00
6949,1974-10-23,Thomasville,Delaware,29634,1210,1210,0,1/11/2022 15:28,4/16/2022 0:04
6950,1990-10-15,Thomasville,District of Columbia,29634,300,300,0,1/11/2022 15:46,1/12/2022 18:06
6951,1997-10-04,Thomasville,Florida,29634,300,300,0,1/11/2022 16:17,1/12/2022 18:40
6952,1971-05-25,Thomasville,Georgia,29634,300,300,0,1/11/2022 16:27,2/18/2022 9:02
6953,1981-07-25,Thomasville,Hawaii,29634,1450,1450,0,1/11/2022 16:33,3/2/2022 20:54
6954,1992-12-12,Thomasville,Idaho,29634,310,310,0,1/11/2022 16:45,4/10/2022 10:57
6955,1980-01-12,Thomasville,Illinois,29634,300,300,0,1/11/2022 16:46,4/1/2022 16:01
6956,1959-08-24,Thomasville,Indiana,29634,300,300,0,1/11/2022 17:09,2/2/2022 16:48
6957,1981-10-13,Thomasville,Iowa,29634,400,400,0,1/11/2022 17:13,1/12/2022 12:30
6958,1987-09-01,Thomasville,Kansas,29634,300,300,0,1/11/2022 17:20,3/17/2022 12:07
6959,1973-05-02,Thomasville,Kentucky,29634,310,310,0,1/11/2022 17:52,4/20/2022 10:25
6960,1975-08-05,Thomasville,Louisiana,29634,610,610,0,1/11/2022 18:19,4/11/2022 21:11
6961,1989-10-28,Thomasville,Maine,29634,300,300,0,1/11/2022 18:23,1/12/2022 15:29
6962,1979-02-12,Thomasville,Maryland,29634,300,300,0,1/11/2022 18:31,1/11/2022 19:26
6963,1955-02-23,Thomasville,Massachusetts,29634,300,300,0,1/11/2022 19:21,3/8/2022 11:26
6964,1991-10-24,Thomasville,Michigan,29634,300,300,0,1/11/2022 19:51,2/27/2022 16:22
6965,1984-09-01,Thomasville,Minnesota,29634,300,300,0,1/11/2022 19:58,1/17/2022 12:09
6966,1950-09-18,Thomasville,Mississippi,29634,300,300,0,1/11/2022 20:09,2/3/2022 19:21
6967,1966-04-20,Thomasville,Missouri,29634,600,600,0,1/11/2022 20:14,3/2/2022 20:59
6968,1987-04-10,Thomasville,Montana,29634,300,300,0,1/11/2022 20:44,1/12/2022 10:54
6969,2002-08-03,Thomasville,Nebraska,29634,300,300,0,1/11/2022 20:52,1/12/2022 10:03
6970,1979-05-03,Thomasville,Nevada,29634,610,610,0,1/11/2022 21:12,5/22/2022 21:25
6971,1961-08-10,Thomasville,New Hampshire,29634,300,300,0,1/11/2022 21:15,3/13/2022 22:38
6972,1967-08-28,Thomasville,New Jersey,29634,380,380,0,1/11/2022 21:24,6/26/2022 19:07
6973,1971-05-19,Thomasville,New Mexico,29634,300,300,0,1/11/2022 21:26,2/18/2022 16:54
6974,1988-03-20,Thomasville,New York,29634,300,300,0,1/11/2022 21:41,3/15/2022 19:00
6975,1984-08-17,Thomasville,North Carolina,29634,300,300,0,1/11/2022 21:41,3/2/2022 20:24
6976,1979-08-11,Thomasville,North Dakota,29634,300,300,0,1/11/2022 21:55,1/12/2022 18:00
6977,1996-03-09,Thomasville,Ohio,29634,310,310,0,1/11/2022 22:00,5/15/2022 21:19
6978,2000-12-31,Thomasville,Oklahoma,29634,700,700,0,1/11/2022 22:00,3/15/2022 16:39
6979,1983-10-26,Thomasville,Oregon,29634,300,300,0,1/11/2022 22:02,2/3/2022 12:07
6980,1978-06-07,Thomasville,Pennsylvania,29634,300,300,0,1/11/2022 22:25,1/22/2022 14:58
6981,1980-01-28,Thomasville,Rhode Island,29634,300,300,0,1/11/2022 23:30,1/30/2022 20:37
6982,1983-09-28,Thomasville,South Carolina,29634,300,300,0,1/12/2022 1:26,1/20/2022 14:52
6983,1997-02-17,Thomasville,South Dakota,29634,860,860,0,1/12/2022 9:29,5/26/2022 20:27
6984,1982-12-17,Thomasville,Tennessee,29634,310,310,0,1/12/2022 9:29,4/8/2022 18:27
6985,1984-09-08,Thomasville,Texas,29634,300,300,0,1/12/2022 9:30,3/10/2022 9:20
6986,1996-10-27,Thomasville,Utah,29634,1340,1340,0,1/12/2022 9:51,4/15/2022 19:28
6987,1992-04-25,Thomasville,Vermont,29634,300,300,0,1/12/2022 10:00,3/23/2022 9:00
6988,1967-04-23,Thomasville,Virginia,29634,600,600,0,1/12/2022 11:15,3/29/2022 23:47
6989,1985-10-18,Thomasville,Washington,29634,310,310,0,1/12/2022 11:16,4/29/2022 16:01
6990,1959-07-22,Thomasville,West Virginia,29634,300,300,0,1/12/2022 11:22,3/19/2022 13:17
6991,1978-12-08,Thomasville,Wisconsin,29634,460,460,0,1/12/2022 11:31,6/29/2022 18:05
6992,1952-12-10,Thomasville,Wyoming,29634,600,600,0,1/12/2022 11:57,3/16/2022 18:08
6993,1955-09-16,Thomasville,Alabama,29634,950,950,0,1/12/2022 12:12,2/2/2022 19:16
6994,1996-11-26,Thomasville,Alaska,29634,600,600,0,1/12/2022 12:32,3/2/2022 20:37
6995,1958-09-21,Thomasville,Arizona,29634,850,850,0,1/12/2022 12:40,2/12/2022 16:55
6996,1959-10-17,Thomasville,Arkansas,29634,310,310,0,1/12/2022 13:22,6/22/2022 22:13
6997,1974-08-12,Thomasville,California,29634,300,300,0,1/12/2022 13:25,1/12/2022 15:02
6998,1952-05-06,Thomasville,Colorado,29634,300,300,0,1/12/2022 13:26,1/22/2022 10:11
6999,1965-05-21,Thomasville,Connecticut,29634,300,300,0,1/12/2022 13:33,3/12/2022 13:46
7000,1987-09-03,Thomasville,Delaware,29634,300,300,0,1/12/2022 13:59,3/27/2022 22:17
7001,1971-02-14,Thomasville,District of Columbia,29634,300,300,0,1/12/2022 14:45,4/5/2022 0:45
7002,1983-11-25,Thomasville,Florida,29634,320,320,0,1/12/2022 14:52,4/13/2022 18:04
7003,1973-10-10,Thomasville,Georgia,29634,300,300,0,1/12/2022 15:27,1/12/2022 15:27
7004,1961-10-17,Thomasville,Hawaii,29634,1050,1050,0,1/12/2022 15:27,3/14/2022 9:04
7005,2005-11-02,Thomasville,Idaho,29634,300,300,0,1/12/2022 15:44,1/22/2022 19:09
7006,1953-11-11,Thomasville,Illinois,29634,300,300,0,1/12/2022 16:20,3/30/2022 20:27
7007,1998-09-27,Thomasville,Indiana,29634,310,310,0,1/12/2022 16:35,5/9/2022 18:22
7008,1977-11-18,Thomasville,Iowa,29634,600,600,0,1/12/2022 16:47,3/18/2022 15:27
7009,1962-03-24,Thomasville,Kansas,29634,600,600,0,1/12/2022 17:04,3/17/2022 12:14
7010,1972-06-15,Thomasville,Kentucky,29634,300,300,0,1/12/2022 17:12,3/30/2022 1:09
7011,1955-07-04,Thomasville,Louisiana,29634,310,310,0,1/12/2022 17:16,4/16/2022 15:29
7012,1951-05-01,Thomasville,Maine,29634,1350,1350,0,1/12/2022 17:31,2/26/2022 19:10
7013,1958-03-02,Thomasville,Maryland,29634,600,600,0,1/12/2022 17:34,1/22/2022 20:22
7014,1982-04-25,Thomasville,Massachusetts,29634,400,400,0,1/12/2022 17:47,2/26/2022 19:12
7015,1987-04-12,Thomasville,Michigan,29634,300,300,0,1/12/2022 17:48,1/12/2022 17:48
7016,1967-12-11,Thomasville,Minnesota,29634,300,300,0,1/12/2022 17:53,1/12/2022 18:10
7017,1953-03-24,Thomasville,Mississippi,29634,360,360,0,1/12/2022 18:09,5/25/2022 15:47
7018,1983-09-23,Thomasville,Missouri,29634,310,310,0,1/12/2022 18:15,5/23/2022 19:27
7019,2001-01-17,Thomasville,Montana,29634,800,800,0,1/12/2022 18:25,2/26/2022 19:01
7020,1953-05-23,Thomasville,Nebraska,29634,300,300,0,1/12/2022 19:23,1/18/2022 14:45
7021,1998-11-24,Thomasville,Nevada,29634,860,860,0,1/12/2022 20:25,4/24/2022 8:55
7022,1953-06-11,Thomasville,New Hampshire,29634,550,550,0,1/12/2022 20:30,4/3/2022 21:02
7023,1982-01-11,Thomasville,New Jersey,29634,850,850,0,1/13/2022 9:49,1/13/2022 20:41
7024,2003-09-20,Thomasville,New Mexico,29634,1770,1770,0,1/13/2022 18:48,4/9/2022 14:10
7025,1958-09-09,Thomasville,New York,29634,300,300,0,1/17/2022 13:55,2/18/2022 17:55
7026,1989-06-25,Thomasville,North Carolina,29634,300,300,0,1/17/2022 14:04,1/24/2022 8:23
7027,1969-07-15,Thomasville,North Dakota,29634,980,980,0,1/17/2022 14:19,5/29/2022 2:57
7028,1962-04-17,Thomasville,Ohio,29634,1250,1250,0,1/17/2022 15:02,3/23/2022 9:13
7029,1953-10-10,Thomasville,Oklahoma,29634,300,300,0,1/17/2022 15:22,3/15/2022 23:59
7030,1996-02-09,Thomasville,Oregon,29634,300,300,0,1/17/2022 18:34,1/19/2022 12:17
7031,1973-01-17,Thomasville,Pennsylvania,29634,300,300,0,1/18/2022 9:19,1/22/2022 20:22
7032,2000-09-07,Thomasville,Rhode Island,29634,400,400,0,1/18/2022 14:38,3/10/2022 10:38
7033,1972-07-19,Thomasville,South Carolina,29634,310,310,0,1/18/2022 14:43,4/16/2022 18:28
7034,1989-08-27,Thomasville,South Dakota,29634,300,300,0,1/18/2022 15:33,3/27/2022 2:42
7035,1997-08-07,Thomasville,Tennessee,29634,860,860,0,1/18/2022 15:52,2/13/2022 20:45
7036,1996-06-02,Thomasville,Texas,29634,310,310,0,1/18/2022 17:09,4/15/2022 19:03
7037,1998-06-26,Thomasville,Utah,29634,720,720,0,1/18/2022 17:24,4/18/2022 18:16
7038,1978-08-04,Thomasville,Vermont,29634,300,300,0,1/18/2022 19:07,3/14/2022 17:43
7039,1969-11-02,Thomasville,Virginia,29634,600,600,0,1/18/2022 19:12,1/22/2022 19:35
7040,1984-05-27,Thomasville,Washington,29634,300,300,0,1/18/2022 21:48,1/26/2022 0:12
7041,1998-01-18,Thomasville,West Virginia,29634,600,600,0,1/18/2022 22:20,1/22/2022 19:35
7042,1952-06-20,Thomasville,Wisconsin,29634,300,300,0,1/19/2022 10:39,1/30/2022 23:42
7043,1984-07-18,Thomasville,Wyoming,29634,310,310,0,1/19/2022 11:26,5/2/2022 19:27
7044,2001-06-25,Thomasville,Alabama,29634,600,600,0,1/19/2022 19:03,1/22/2022 19:40
7045,1989-09-23,Thomasville,Alaska,29634,600,600,0,1/20/2022 10:11,1/24/2022 19:55
7046,1968-01-02,Thomasville,Arizona,29634,400,400,0,1/20/2022 10:12,4/1/2022 12:43
7047,1962-08-03,Thomasville,Arkansas,29634,300,300,0,1/20/2022 12:08,3/23/2022 19:23
7048,1973-09-27,Thomasville,California,29634,300,300,0,1/20/2022 13:40,2/19/2022 13:14
7049,2005-01-02,Thomasville,Colorado,29634,850,850,0,1/20/2022 16:16,2/26/2022 19:16
7050,1986-08-03,Thomasville,Connecticut,29634,780,780,0,1/20/2022 17:23,4/20/2022 15:07
7051,2001-06-26,Thomasville,Delaware,29634,310,310,0,1/20/2022 19:43,4/8/2022 19:36
7052,1978-06-13,Thomasville,District of Columbia,29634,300,300,0,1/20/2022 23:29,1/22/2022 16:05
7053,1955-08-02,Thomasville,Florida,29634,600,600,0,1/21/2022 0:02,1/25/2022 19:11
7054,2005-09-10,Thomasville,Georgia,29634,540,540,0,1/21/2022 8:12,6/24/2022 13:01
7055,1950-08-20,Thomasville,Hawaii,29634,600,600,0,1/21/2022 11:12,1/22/2022 19:52
7056,1974-02-01,Thomasville,Idaho,29634,600,600,0,1/21/2022 11:38,3/15/2022 16:49
7057,1971-02-26,Thomasville,Illinois,29634,310,310,0,1/21/2022 12:28,4/11/2022 14:00
7058,1963-05-25,Thomasville,Indiana,29634,300,300,0,1/21/2022 13:34,1/22/2022 17:54
7059,1954-06-20,Thomasville,Iowa,29634,300,300,0,1/21/2022 15:50,1/22/2022 17:57
7060,1964-11-08,Thomasville,Kansas,29634,300,300,0,1/21/2022 16:15,1/21/2022 16:15
7061,1988-01-18,Thomasville,Kentucky,29634,600,600,0,1/21/2022 18:01,1/22/2022 20:02
7062,1978-02-24,Thomasville,Louisiana,29634,600,600,0,1/21/2022 18:14,1/22/2022 19:08
7063,1967-09-07,Thomasville,Maine,29634,320,320,0,1/21/2022 20:06,5/17/2022 12:46
7064,2001-09-16,Thomasville,Maryland,29634,300,300,0,1/21/2022 20:15,2/28/2022 9:04
7065,1994-01-03,Thomasville,Massachusetts,29634,300,300,0,1/21/2022 21:40,2/28/2022 22:42
7066,1969-04-23,Thomasville,Michigan,29634,610,610,0,1/21/2022 22:37,4/9/2022 14:10
7067,1998-05-25,Thomasville,Minnesota,29634,320,320,0,1/21/2022 22:38,6/17/2022 13:53
7068,1971-12-25,Thomasville,Mississippi,29634,300,300,0,1/21/2022 22:54,1/21/2022 22:54
7069,1970-08-26,Thomasville,Missouri,29634,300,300,0,1/22/2022 0:00,1/22/2022 0:01
7070,1985-08-09,Thomasville,Montana,29634,300,300,0,1/22/2022 1:12,1/22/2022 20:46
7071,1998-03-21,Thomasville,Nebraska,29634,2600,2600,0,1/22/2022 2:32,5/11/2022 15:13
7072,1975-08-06,Thomasville,Nevada,29634,340,340,0,1/22/2022 9:18,5/11/2022 18:13
7073,1977-10-13,Thomasville,New Hampshire,29634,300,300,0,1/22/2022 11:26,3/2/2022 16:36
7074,1961-05-28,Thomasville,New Jersey,29634,910,910,0,1/22/2022 11:36,4/17/2022 12:54
7075,1953-12-01,Thomasville,New Mexico,29634,300,300,0,1/22/2022 11:36,1/22/2022 18:34
7076,2003-11-02,Thomasville,New York,29634,600,600,0,1/22/2022 11:56,1/22/2022 18:43
7077,2005-10-21,Thomasville,North Carolina,29634,560,560,0,1/22/2022 12:26,4/8/2022 18:50
7078,1969-07-01,Thomasville,North Dakota,29634,600,600,0,1/22/2022 12:27,1/22/2022 18:50
7079,2004-02-24,Thomasville,Ohio,29634,300,300,0,1/22/2022 12:28,2/24/2022 19:33
7080,1973-09-10,Thomasville,Oklahoma,29634,320,320,0,1/22/2022 12:29,4/13/2022 12:19
7081,1954-01-11,Thomasville,Oregon,29634,610,610,0,1/22/2022 12:40,4/10/2022 9:40
7082,1969-09-28,Thomasville,Pennsylvania,29634,300,300,0,1/22/2022 12:44,3/2/2022 21:07
7083,1966-04-02,Thomasville,Rhode Island,29634,300,300,0,1/22/2022 12:45,2/6/2022 15:13
7084,1968-04-22,Thomasville,South Carolina,29634,800,800,0,1/22/2022 13:04,3/6/2022 13:28
7085,1960-10-16,Thomasville,South Dakota,29634,750,750,0,1/22/2022 13:06,2/19/2022 12:47
7086,1977-12-21,Thomasville,Tennessee,29634,500,500,0,1/22/2022 13:36,2/26/2022 19:23
7087,1972-08-24,Thomasville,Texas,29634,310,310,0,1/22/2022 13:41,5/4/2022 13:29
7088,1965-05-26,Thomasville,Utah,29634,300,300,0,1/22/2022 13:41,1/22/2022 19:25
7089,1998-09-20,Thomasville,Vermont,29634,320,320,0,1/22/2022 14:04,4/18/2022 18:02
7090,2000-02-06,Thomasville,Virginia,29634,400,400,0,1/22/2022 14:07,3/10/2022 0:59
7091,1998-09-18,Thomasville,Washington,29634,310,310,0,1/22/2022 14:14,5/3/2022 13:35
7092,1983-11-19,Thomasville,West Virginia,29634,300,300,0,1/22/2022 14:27,1/22/2022 18:01
7093,2000-12-13,Thomasville,Wisconsin,29634,400,400,0,1/22/2022 14:33,1/22/2022 19:22
7094,1997-02-10,Thomasville,Wyoming,29634,300,300,0,1/22/2022 14:39,2/1/2022 21:38
7095,1974-09-24,Thomasville,Alabama,29634,300,300,0,1/22/2022 15:17,2/26/2022 19:11
7096,1990-05-03,Thomasville,Alaska,29634,500,500,0,1/22/2022 15:27,3/1/2022 12:00
7097,1991-09-03,Thomasville,Arizona,29634,500,500,0,1/22/2022 16:27,3/16/2022 15:19
7098,1983-01-03,Thomasville,Arkansas,29634,610,610,0,1/22/2022 17:39,5/6/2022 12:24
7099,1973-05-05,Thomasville,California,29634,320,320,0,1/22/2022 18:17,4/18/2022 12:42
7100,1978-07-07,Thomasville,Colorado,29634,300,300,0,1/22/2022 18:19,1/22/2022 19:38
7101,1950-06-02,Thomasville,Connecticut,29634,300,300,0,1/22/2022 18:38,1/24/2022 1:42
7102,2005-03-24,Thomasville,Delaware,29634,300,300,0,1/22/2022 18:48,1/22/2022 20:27
7103,1981-02-16,Thomasville,District of Columbia,29634,300,300,0,1/22/2022 18:52,2/11/2022 19:38
7104,2000-02-22,Thomasville,Florida,29634,680,680,0,1/22/2022 19:41,5/24/2022 9:46
7105,1966-03-15,Thomasville,Georgia,29634,300,300,0,1/22/2022 21:34,3/25/2022 10:03
7106,1955-12-04,Thomasville,Hawaii,29634,300,300,0,1/23/2022 21:35,1/23/2022 21:41
7107,1996-10-12,Thomasville,Idaho,29634,1650,1650,0,1/24/2022 9:18,5/11/2022 13:21
7108,1973-11-14,Thomasville,Illinois,29634,850,850,0,1/24/2022 10:11,3/2/2022 20:53
7109,1988-03-23,Thomasville,Indiana,29634,300,300,0,1/24/2022 12:03,2/1/2022 10:25
7110,1971-10-21,Thomasville,Iowa,29634,300,300,0,1/24/2022 16:03,1/24/2022 16:04
7111,1979-01-20,Thomasville,Kansas,29634,650,650,0,2/2/2022 12:31,2/26/2022 15:55
7112,1988-11-27,Thomasville,Kentucky,29634,310,310,0,2/2/2022 14:34,4/23/2022 18:06
7113,1968-11-25,Thomasville,Louisiana,29634,400,400,0,2/3/2022 18:23,2/3/2022 22:10
7114,1998-04-24,Winston-Salem ,North Carolina,27101,800,800,0,2/4/2022 19:19,2/4/2022 19:51
7115,1950-07-17,Thomasville,Maine,29634,700,700,0,2/4/2022 19:23,2/4/2022 19:48
7116,1977-12-04,Thomasville,Maryland,29634,840,840,0,2/5/2022 7:57,6/26/2022 15:13
7117,1988-06-23,Thomasville,Massachusetts,29634,300,300,0,2/10/2022 17:35,3/14/2022 9:59
7118,1960-01-06,Thomasville,Michigan,29634,300,300,0,2/11/2022 10:57,2/22/2022 11:13
7119,1957-08-16,Thomasville,Minnesota,29634,660,660,0,2/12/2022 14:01,5/20/2022 14:22
7120,1995-03-07,Thomasville,Mississippi,29634,750,750,0,2/12/2022 14:47,2/12/2022 15:03
7121,1951-01-20,Thomasville,Missouri,29634,650,650,0,2/12/2022 16:31,2/12/2022 16:33
7122,1960-10-16,Thomasville,Montana,29634,350,350,0,2/13/2022 0:53,6/1/2022 21:21
7123,1993-08-22,Thomasville,Nebraska,29634,300,300,0,2/17/2022 14:17,2/19/2022 12:20
7124,1964-05-25,Thomasville,Nevada,29634,300,300,0,2/17/2022 14:17,2/17/2022 14:38
7125,1961-06-10,Thomasville,New Hampshire,29634,1260,1260,0,2/18/2022 10:34,4/18/2022 12:37
7126,1997-12-16,Thomasville,New Jersey,29634,300,300,0,2/18/2022 15:23,2/18/2022 15:27
7127,1972-10-26,Thomasville,New Mexico,29634,300,300,0,2/18/2022 17:14,2/18/2022 17:14
7128,1990-05-10,Thomasville,New York,29634,320,320,0,2/18/2022 17:14,4/13/2022 9:03
7129,1993-08-25,Thomasville,North Carolina,29634,910,910,0,2/18/2022 18:23,3/22/2022 9:56
7130,1963-04-13,Thomasville,North Dakota,29634,660,660,0,2/18/2022 20:35,4/8/2022 22:16
7131,1999-12-15,Thomasville,Ohio,29634,750,750,0,2/18/2022 20:40,3/1/2022 17:37
7132,1973-08-16,Thomasville,Oklahoma,29634,330,330,0,2/19/2022 0:44,5/11/2022 13:03
7133,1983-01-17,Thomasville,Oregon,29634,300,300,0,2/19/2022 2:37,2/19/2022 15:33
7134,1952-06-05,Thomasville,Pennsylvania,29634,300,300,0,2/19/2022 11:00,3/5/2022 19:24
7135,1961-01-12,Thomasville,Rhode Island,29634,300,300,0,2/19/2022 11:50,3/2/2022 20:15
7136,1959-03-22,Thomasville,South Carolina,29634,300,300,0,2/19/2022 12:24,2/19/2022 12:25
7137,1964-04-17,Thomasville,South Dakota,29634,510,510,0,2/19/2022 12:32,5/11/2022 10:16
7138,1981-09-20,Thomasville,Tennessee,29634,300,300,0,2/19/2022 12:53,2/19/2022 12:56
7139,1967-02-14,Thomasville,Texas,29634,300,300,0,2/19/2022 13:48,2/19/2022 14:17
7140,1953-06-16,Thomasville,Utah,29634,300,300,0,2/24/2022 15:04,2/28/2022 20:59
7141,1961-08-19,Thomasville,Vermont,29634,300,300,0,2/24/2022 18:39,2/24/2022 18:40
7142,2003-03-22,Thomasville,Virginia,29634,1360,1360,0,2/25/2022 12:56,5/12/2022 11:08
7143,1982-09-07,Thomasville,Washington,29634,330,330,0,2/25/2022 16:05,4/15/2022 11:25
7144,1974-08-07,Thomasville,West Virginia,29634,300,300,0,2/25/2022 16:10,2/26/2022 18:48
7145,1979-04-26,Thomasville,Wisconsin,29634,300,300,0,2/25/2022 19:18,2/26/2022 15:47
7146,1985-11-19,Thomasville,Wyoming,29634,300,300,0,2/25/2022 19:31,2/25/2022 19:32
7147,1964-05-04,Thomasville,Alabama,29634,330,330,0,2/26/2022 11:00,6/5/2022 15:12
7148,1972-05-17,Thomasville,Alaska,29634,300,300,0,2/26/2022 12:28,2/26/2022 12:31
7149,2000-01-27,Thomasville,Arizona,29634,600,600,0,2/26/2022 14:56,3/19/2022 18:10
7150,1999-01-07,Thomasville,Arkansas,29634,420,420,0,2/26/2022 15:08,4/26/2022 11:42
7151,1955-03-05,Thomasville,California,29634,300,300,0,2/26/2022 15:55,3/31/2022 14:37
7152,1996-02-04,Thomasville,Colorado,29634,300,300,0,2/26/2022 16:33,4/1/2022 20:43
7153,1991-11-26,Thomasville,Connecticut,29634,850,850,0,2/26/2022 16:54,3/2/2022 20:46
7154,1989-02-17,Thomasville,Delaware,29634,600,600,0,2/26/2022 16:55,5/11/2022 17:25
7155,1955-05-07,Thomasville,District of Columbia,29634,300,300,0,2/26/2022 17:20,2/26/2022 19:10
7156,1969-03-07,Thomasville,Florida,29634,300,300,0,2/26/2022 18:15,2/26/2022 19:00
7157,1968-04-15,Thomasville,Georgia,29634,300,300,0,2/26/2022 18:41,2/26/2022 19:27
7158,1957-02-06,Thomasville,Hawaii,29634,300,300,0,2/26/2022 19:23,2/26/2022 19:24
7159,1997-09-14,Thomasville,Idaho,29634,400,400,0,2/27/2022 23:04,3/25/2022 9:14
7160,1961-05-23,Thomasville,Illinois,29634,300,300,0,2/28/2022 16:17,2/28/2022 22:07
7161,1983-03-23,Thomasville,Indiana,29634,300,300,0,2/28/2022 18:06,3/12/2022 10:44
7162,1951-11-08,Thomasville,Iowa,29634,850,850,0,2/28/2022 20:19,3/11/2022 10:53
7163,1999-04-09,Thomasville,Kansas,29634,1050,1050,0,3/1/2022 12:44,6/19/2022 12:03
7164,1980-12-22,Thomasville,Kentucky,29634,850,850,0,3/1/2022 14:26,3/3/2022 0:27
7165,1981-03-28,Thomasville,Louisiana,29634,300,300,0,3/1/2022 21:37,3/2/2022 19:51
7166,1982-06-08,Thomasville,Maine,29634,300,300,0,3/2/2022 10:49,3/2/2022 23:42
7167,1994-12-15,Thomasville,Maryland,29634,620,620,0,3/2/2022 13:35,4/22/2022 11:46
7168,1973-12-26,Thomasville,Massachusetts,29634,300,300,0,3/2/2022 13:57,3/2/2022 20:04
7169,1997-09-28,Thomasville,Michigan,29634,300,300,0,3/2/2022 15:34,3/2/2022 20:04
7170,1970-05-09,Thomasville,Minnesota,29634,300,300,0,3/2/2022 18:50,3/2/2022 19:48
7171,1996-04-24,Thomasville,Mississippi,29634,310,310,0,3/2/2022 18:56,5/10/2022 18:46
7172,1987-11-07,Thomasville,Missouri,29634,300,300,0,3/2/2022 19:28,3/2/2022 20:47
7173,1994-11-07,Thomasville,Montana,29634,300,300,0,3/2/2022 20:52,3/2/2022 20:54
7174,1968-10-14,Thomasville,Nebraska,29634,300,300,0,3/4/2022 16:26,3/26/2022 20:45
7175,1987-07-14,Thomasville,Nevada,29634,500,500,0,3/5/2022 16:20,3/5/2022 16:20
7176,1959-04-27,Thomasville,New Hampshire,29634,500,500,0,3/15/2022 16:13,3/15/2022 17:45
7177,1991-01-13,Thomasville,New Jersey,29634,410,410,0,3/17/2022 17:06,4/5/2022 17:07
7178,1966-05-24,Thomasville,New Mexico,29634,300,300,0,3/19/2022 11:12,3/19/2022 15:34
7179,1981-02-10,Thomasville,New York,29634,310,310,0,3/25/2022 17:05,6/19/2022 17:38
7180,2000-02-12,Thomasville,North Carolina,29634,560,560,0,4/7/2022 14:46,4/8/2022 19:01
7181,1969-05-03,Thomasville,North Dakota,29634,310,310,0,4/8/2022 12:59,4/8/2022 18:06
7182,1985-08-16,Thomasville,Ohio,29634,560,560,0,4/9/2022 16:07,4/9/2022 16:16
7183,1975-10-09,Thomasville,Oklahoma,29634,350,350,0,4/11/2022 11:46,5/11/2022 13:02
7184,1972-10-01,Thomasville,Oregon,29634,580,580,0,4/15/2022 18:08,4/19/2022 18:06
7185,2001-01-24,Thomasville,Pennsylvania,29634,310,310,0,4/16/2022 10:41,4/16/2022 18:30
7186,1981-11-18,Thomasville,Rhode Island,29634,330,330,0,4/16/2022 16:40,6/23/2022 8:28
7187,1964-04-11,Thomasville,South Carolina,29634,310,310,0,4/19/2022 18:07,4/19/2022 19:05
7188,1958-11-08,Thomasville,South Dakota,29634,310,310,0,4/23/2022 18:05,4/23/2022 18:13
7189,1969-04-09,Thomasville,Tennessee,29634,360,360,0,4/27/2022 10:38,5/7/2022 17:32
7190,1991-06-07,Thomasville,Texas,29634,700,700,0,4/27/2022 10:40,5/7/2022 19:22
7191,1991-06-17,Thomasville,Utah,29634,310,310,0,5/3/2022 17:58,5/3/2022 18:10
7192,1981-06-27,Thomasville,Vermont,29634,310,310,0,5/6/2022 18:02,5/6/2022 18:08
7193,1984-12-19,Thomasville,Virginia,29634,630,630,0,5/14/2022 8:43,6/30/2022 1:07
7194,1964-08-28,Thomasville,Washington,29634,110,110,0,5/16/2022 12:50,5/16/2022 12:54
7195,1981-11-14,Thomasville,West Virginia,29634,310,310,0,5/19/2022 8:01,5/19/2022 10:12
7196,1957-03-27,Thomasville,Wisconsin,29634,310,310,0,6/5/2022 20:41,6/5/2022 20:42
7197,2004-04-20,Thomasville,Wyoming,29634,420,420,0,6/6/2022 18:21,6/10/2022 21:50
7198,1969-12-19,Thomasville,Alabama,29634,320,320,0,6/7/2022 15:34,6/21/2022 13:09
7199,1999-08-27,Thomasville,Alaska,29634,590,590,0,6/7/2022 15:35,6/30/2022 14:05
7200,2000-07-24,Winston-Salem ,North Carolina,27106,640,640,0,6/7/2022 15:37,7/1/2022 0:57
7201,1970-11-03,Thomasville,Arizona,29634,310,310,0,6/13/2022 21:36,6/13/2022 21:37
7202,1973-02-06,Thomasville,Arkansas,29634,320,320,0,6/14/2022 23:14,6/23/2022 11:35
7203,1968-10-20,Thomasville,California,29634,320,320,0,6/15/2022 1:26,6/26/2022 1:12
7204,2003-09-24,Thomasville,Colorado,29634,330,330,0,6/16/2022 20:29,7/1/2022 8:28
7205,2003-12-05,Thomasville,Connecticut,29634,410,410,0,6/17/2022 20:39,6/17/2022 20:40
7206,1973-06-01,Thomasville,Delaware,29634,310,310,0,6/21/2022 16:55,6/21/2022 16:58
7207,2004-03-12,Thomasville,District of Columbia,29634,420,420,0,6/21/2022 21:17,6/25/2022 12:21
7208,2000-09-24,Thomasville,Florida,29634,410,410,0,6/22/2022 8:44,6/22/2022 8:47
7209,1999-05-07,Thomasville,Georgia,29634,420,420,0,6/22/2022 9:52,6/26/2022 22:40
7210,1996-12-29,Thomasville,Hawaii,29634,410,410,0,6/22/2022 11:14,6/22/2022 12:41
7211,1970-07-15,Thomasville,Idaho,29634,320,320,0,6/22/2022 11:17,6/29/2022 15:46
7212,1981-01-19,Thomasville,Illinois,29634,410,410,0,6/22/2022 11:54,6/22/2022 11:56
7213,1958-03-14,Thomasville,Indiana,29634,310,310,0,6/22/2022 12:45,6/22/2022 14:00
7214,1987-10-12,Thomasville,Iowa,29634,310,310,0,6/22/2022 14:48,6/22/2022 19:45
7215,2004-01-17,Rome,Georgia,30165,420,420,0,6/22/2022 15:28,6/23/2022 13:24
7216,1984-06-10,Thomasville,Kansas,29634,310,310,0,6/22/2022 15:34,6/22/2022 15:34
7217,2004-01-08,Delhi,New York,13753,460,460,0,6/22/2022 15:50,6/29/2022 21:26
7218,1956-11-08,Thomasville,Kentucky,29634,310,310,0,6/22/2022 17:14,6/22/2022 17:15
7219,2004-06-12,Lutherville,Maryland,21093,490,490,0,6/22/2022 17:28,6/30/2022 8:43
7220,1999-08-07,Winston-Salem,North Carolina,27106,430,430,0,6/22/2022 17:36,6/26/2022 16:39
7219,2004-06-12,Lutherville,Maryland,21093,490,490,0,6/22/2022 17:28,6/30/2022 8:43
7220,1999-08-07,Winston-Salem,North Carolina,27106,430,430,0,6/22/2022 17:36,6/26/2022 16:39
7221,1968-01-03,Thomasville,Louisiana,29634,310,310,0,6/22/2022 18:19,6/22/2022 18:20
7222,1965-06-02,Thomasville,Maine,29634,310,310,0,6/22/2022 19:29,6/22/2022 19:29
7223,1959-08-23,Thomasville,Maryland,29634,330,330,0,6/22/2022 20:39,6/29/2022 19:15
7224,2000-08-16,Thomasville,Massachusetts,29634,420,420,0,6/23/2022 14:25,6/24/2022 15:45
7225,1968-08-18,Thomasville,Michigan,29634,310,310,0,6/23/2022 16:51,6/23/2022 16:54
7226,1988-03-10,Thomasville,Minnesota,29634,310,310,0,6/23/2022 17:21,6/23/2022 17:22
7227,2000-03-14,Clemmons,North Carolina,27012,460,460,0,6/23/2022 22:18,6/29/2022 23:40
7228,1997-04-27,Thomasville,Mississippi,29634,430,430,0,6/24/2022 3:32,7/1/2022 2:36
7229,1999-10-25,Thomasville,Missouri,29634,410,410,0,6/24/2022 15:13,6/24/2022 18:19
7230,1999-05-18,Winston-Salem,North Carolina,27107,410,410,0,6/24/2022 16:03,6/24/2022 16:06
7231,2005-04-15,Thomasville,Montana,29634,310,310,0,6/24/2022 17:03,6/24/2022 17:05
7232,1955-11-14,Thomasville,Nebraska,29634,310,310,0,6/24/2022 19:27,6/24/2022 19:28
7233,1979-09-10,Thomasville,Nevada,29634,420,420,0,6/25/2022 12:21,6/30/2022 18:09
7234,1991-06-04,Thomasville,New Hampshire,29634,310,310,0,6/25/2022 16:07,6/25/2022 16:23
7235,2004-06-20,Guaynabo,Puerto Rico,969,440,440,0,6/27/2022 10:21,7/1/2022 8:36
7236,1991-09-27,Thomasville,New Jersey,29634,310,310,0,6/27/2022 18:22,6/27/2022 18:22
7237,2003-10-19,Thomasville,New Mexico,29634,410,410,0,6/28/2022 12:14,6/28/2022 12:19
7238,1958-09-06,Thomasville,New York,29634,320,320,0,6/28/2022 21:02,6/30/2022 12:04
7239,1990-10-09,Thomasville,North Carolina,29634,310,310,0,6/28/2022 22:43,6/28/2022 22:43
7240,1997-03-03,Thomasville,North Dakota,29634,410,410,0,6/30/2022 12:47,6/30/2022 12:48
7241,1953-03-04,Thomasville,Ohio,29634,310,310,0,6/30/2022 20:38,6/30/2022 20:39
7242,1990-07-01,Thomasville,Oklahoma,29634,310,310,0,7/1/2022 2:27,7/1/2022 2:42
